State,Year,OD_rate_AIAN,deaths_AIAN,population_AIAN,OD_rate_ALL,deaths_ALL,population_ALL,PL280,PL280_3cat,Year_Factor,deaths_non_AIAN,pop_non_AIAN,OD_rate_non_AIAN,base_crim,added_states,state_crim,interact,state_code
AK,1999,1.9862475999508168e-4,21,105727,1.8406508541420245e-4,115,624779,1,Mandatory,1999,94,519052,1.8109938888589196e-4,1,0,1,1.8406508541420245e-4,02
AK,2000,2.5066146776215014e-4,27,107715,1.9459845724895204e-4,122,626932,1,Mandatory,2000,95,519217,1.8296781499835328e-4,1,0,1,1.9459845724895204e-4,02
AK,2001,1.8396725382881847e-4,20,108715,2.2880984166358956e-4,145,633714,1,Mandatory,2001,125,524999,2.3809569161084115e-4,1,0,1,2.2880984166358956e-4,02
AK,2002,2.368890994569773e-4,26,109756,2.2106775726760252e-4,142,642337,1,Mandatory,2002,116,532581,2.1780724434405284e-4,1,0,1,2.2106775726760252e-4,02
AK,2003,2.9746881084589315e-4,33,110936,2.297914603941309e-4,149,648414,1,Mandatory,2003,116,537478,2.1582278716524212e-4,1,0,1,2.297914603941309e-4,02
AK,2004,2.484009190834006e-4,28,112721,2.36619615766147e-4,156,659286,1,Mandatory,2004,128,546565,2.3418989507194936e-4,1,0,1,2.36619615766147e-4,02
AK,2005,3.150819212995379e-4,36,114256,2.39899482116993e-4,160,666946,1,Mandatory,2005,124,552690,2.243572346161501e-4,1,0,1,2.39899482116993e-4,02
AK,2006,2.1622369638733447e-4,25,115621,2.3989267024235084e-4,162,675302,1,Mandatory,2006,137,559681,2.447822956291173e-4,1,0,1,2.3989267024235084e-4,02
AK,2007,2.321622039931899e-4,27,116298,2.4694987505512276e-4,168,680300,1,Mandatory,2007,141,564002,2.49999113478321e-4,1,0,1,2.4694987505512276e-4,02
AK,2008,4.941384950926936e-4,58,117376,3.6075088551250627e-4,248,687455,1,Mandatory,2008,190,570079,3.3328714090503247e-4,1,0,1,3.6075088551250627e-4,02
AK,2009,3.603543204806959e-4,43,119327,3.219367716180542e-4,225,698895,1,Mandatory,2009,182,579568,3.1402699942025783e-4,1,0,1,3.219367716180542e-4,02
AK,2010,2.9887424036130575e-4,36,120452,2.6611060345155306e-4,189,710231,1,Mandatory,2010,153,589779,2.594192061772291e-4,1,0,1,2.6611060345155306e-4,02
AK,2011,4.183242422999631e-4,51,121915,2.9887175910936215e-4,216,722718,1,Mandatory,2011,165,600803,2.746324502374322e-4,1,0,1,2.9887175910936215e-4,02
AK,2012,4.8004946950465404e-4,59,122904,3.1991293993156053e-4,234,731449,1,Mandatory,2012,175,608545,2.875711738655317e-4,1,0,1,3.1991293993156053e-4,02
AK,2013,3.0992072554073013e-4,38,122612,2.775011834609295e-4,204,735132,1,Mandatory,2013,166,612520,2.7101155880624307e-4,1,0,1,2.775011834609295e-4,02
AK,2014,0.001459262,180,123350,0.001024796,755,736732,1,Mandatory,2014,575,613382,9.374256173151479e-4,1,0,1,0.001024796,02
AK,2015,0.001750678,217,123952,0.00119984,886,738432,1,Mandatory,2015,669,614480,0.001088725,1,0,1,0.00119984,02
AK,2016,0.002014923,256,127052,0.001302073,966,741894,1,Mandatory,2016,710,614842,0.001154768,1,0,1,0.001302073,02
AK,2017,0.001896195,242,127624,0.001217905,901,739795,1,Mandatory,2017,659,612171,0.001076497,1,0,1,0.001217905,02
AK,2018,0.001944811,249,128033,0.001197389,883,737438,1,Mandatory,2018,634,609405,0.001040359,1,0,1,0.001197389,02
AK,2019,0.002167455,278,128261,0.001368337,1001,731545,1,Mandatory,2019,723,603284,0.001198441,1,0,1,0.001368337,02
AK,2020,0.002384106,306,128350,0.001425137,1042,731158,1,Mandatory,2020,736,602808,0.001220953,1,0,1,0.001425137,02
AL,1999,2.205947233742169e-4,5,22666,7.381254908139493e-5,327,4430141,0,No,1999,322,4407475,7.305770310665404e-5,0,0,0,0,01
AL,2000,0,0,25386,1.0568685210586675e-4,470,4447100,0,No,2000,470,4421714,1.0629362278971458e-4,0,0,0,0,01
AL,2001,0,0,26010,1.2109317817887499e-4,541,4467634,0,No,2001,541,4441624,1.2180229573687462e-4,0,0,0,0,01
AL,2002,1.851646113394808e-4,5,27003,1.1048887644865984e-4,495,4480089,0,No,2002,490,4453086,1.1003605140345369e-4,0,0,0,0,01
AL,2003,0,0,28065,1.1368957992810466e-4,512,4503491,0,No,2003,512,4475426,1.1440251721288655e-4,0,0,0,0,01
AL,2004,1.7256850969835024e-4,5,28974,1.4214048114552868e-4,644,4530729,0,No,2004,639,4501755,1.4194464158978e-4,0,0,0,0,01
AL,2005,1.6690589845445137e-4,5,29957,1.481463651074827e-4,677,4569805,0,No,2005,672,4539848,1.480225769673346e-4,0,0,0,0,01
AL,2006,1.6043638697256537e-4,5,31165,1.8016924243154163e-4,834,4628981,0,No,2006,829,4597816,1.8030299603115913e-4,0,0,0,0,01
AL,2007,1.5492826821181794e-4,5,32273,2.0929456176543601e-4,978,4672840,0,No,2007,973,4640567,2.096726542252272e-4,0,0,0,0,01
AL,2008,1.4917357837579808e-4,5,33518,2.1152107389969831e-4,998,4718206,0,No,2008,993,4684688,2.119671576847807e-4,0,0,0,0,01
AL,2009,0,0,34844,2.3203328836987787e-4,1104,4757938,0,No,2009,1104,4723094,2.3374508320181644e-4,0,0,0,0,01
AL,2010,1.3903178266551735e-4,5,35963,2.117271748899939e-4,1012,4779736,0,No,2010,1007,4743773,2.1227828565995887e-4,0,0,0,0,01
AL,2011,1.375591504346869e-4,5,36348,2.2403877786430246e-4,1076,4802740,0,No,2011,1071,4766392,2.2469826233343797e-4,0,0,0,0,01
AL,2012,1.363252174387218e-4,5,36677,2.368300607442146e-4,1142,4822023,0,No,2012,1137,4785346,2.3760037414222504e-4,0,0,0,0,01
AL,2013,1.3626205919223852e-4,5,36694,2.4142886165153893e-4,1167,4833722,0,No,2013,1162,4797028,2.4223331612823607e-4,0,0,0,0,01
AL,2014,1.3540961408259986e-4,5,36925,2.7158127734758507e-4,1317,4849377,0,No,2014,1312,4812452,2.726260958031374e-4,0,0,0,0,01
AL,2015,1.3430751047598582e-4,5,37228,2.852451101352774e-4,1386,4858979,0,No,2015,1381,4821751,2.8641047619422903e-4,0,0,0,0,01
AL,2016,4.5711212691583756e-4,17,37190,9.641601381777806e-4,4689,4863300,0,No,2016,4672,4826110,9.680674497680327e-4,0,0,0,0,01
AL,2017,2.9392902949978625e-4,11,37424,0.001024874,4996,4874747,0,No,2017,4985,4837323,0.001030529,0,0,0,0,01
AL,2018,4.4985445885154803e-4,17,37790,0.001019462,4983,4887871,0,No,2018,4966,4850081,0.0010239,0,0,0,0,01
AL,2019,4.4437473860309496e-4,17,38256,9.838502932277692e-4,4824,4903185,0,No,2019,4807,4864929,9.880925292023788e-4,0,0,0,0,01
AL,2020,4.433202075781678e-4,17,38347,0.001130745,5565,4921532,0,No,2020,5548,4883185,0.001136144,0,0,0,0,01
AZ,1999,1.053449866684103e-4,29,275286,1.958667731725421e-4,984,5023823,1,Optional,1999,955,4748537,2.0111457486800673e-4,0,0,0,1.958667731725421e-4,04
AZ,2000,9.702980971376206e-5,27,278265,1.8438274271083952e-4,946,5130632,1,Optional,2000,919,4852367,1.8939210492528697e-4,0,0,0,1.8438274271083952e-4,04
AZ,2001,1.0537222739326671e-4,30,284705,1.8261196550207765e-4,963,5273477,1,Optional,2001,933,4988772,1.8701997204923377e-4,0,0,0,1.8261196550207765e-4,04
AZ,2002,1.3381001722375093e-4,39,291458,1.9439407515026624e-4,1049,5396255,1,Optional,2002,1010,5104797,1.9785311737175837e-4,0,0,0,1.9439407515026624e-4,04
AZ,2003,1.1720071124088764e-4,35,298633,2.0452369389753562e-4,1127,5510364,1,Optional,2003,1092,5211731,2.0952731443737215e-4,0,0,0,2.0452369389753562e-4,04
AZ,2004,1.5020113891646205e-4,46,306256,2.1141447072785315e-4,1195,5652404,1,Optional,2004,1149,5346148,2.1492109833098522e-4,0,0,0,2.1141447072785315e-4,04
AZ,2005,1.2966599936115776e-4,41,316197,2.3102966444867913e-4,1349,5839077,1,Optional,2005,1308,5522880,2.3683295671823396e-4,0,0,0,2.3102966444867913e-4,04
AZ,2006,1.3147515119642388e-4,43,327058,2.4630374376714695e-4,1485,6029141,1,Optional,2006,1442,5702083,2.528900403589355e-4,0,0,0,2.4630374376714695e-4,04
AZ,2007,9.501187648456056e-5,32,336800,2.331508390268563e-4,1438,6167681,1,Optional,2007,1406,5830881,2.4112994245638008e-4,0,0,0,2.331508390268563e-4,04
AZ,2008,1.1254144555158294e-4,39,346539,2.1081587335252332e-4,1324,6280362,1,Optional,2008,1285,5933823,2.1655516182400453e-4,0,0,0,2.1081587335252332e-4,04
AZ,2009,1.5008042045171376e-4,53,353144,2.415202279496919e-4,1532,6343154,1,Optional,2009,1479,5990010,2.4691110699314356e-4,0,0,0,2.415202279496919e-4,04
AZ,2010,3.235830687948762e-4,116,358486,0.001045992,6686,6392017,1,Optional,2010,6570,6033531,0.001088915,0,0,0,0.001045992,04
AZ,2011,3.30139236222877e-4,120,363483,0.001075202,6970,6482505,1,Optional,2011,6850,6119022,0.00111946,0,0,0,0.001075202,04
AZ,2012,3.703143076473959e-4,137,369956,0.001134398,7434,6553255,1,Optional,2012,7297,6183299,0.001180114,0,0,0,0.001134398,04
AZ,2013,4.49330656846975e-4,169,376115,0.001159716,7685,6626624,1,Optional,2013,7516,6250509,0.001202462,0,0,0,0.001159716,04
AZ,2014,4.466046295401539e-4,171,382889,0.001142096,7688,6731484,1,Optional,2014,7517,6348595,0.001184042,0,0,0,0.001142096,04
AZ,2015,4.19411280362289e-4,163,388640,0.001208688,8253,6828065,1,Optional,2015,8090,6439425,0.001256323,0,0,0,0.001208688,04
AZ,2016,4.976875125678664e-4,198,397840,0.001300376,9013,6931071,1,Optional,2016,8815,6533231,0.001349256,0,0,0,0.001300376,04
AZ,2017,5.720395081959023e-4,229,400322,0.001331762,9344,7016270,1,Optional,2017,9115,6615948,0.001377732,0,0,0,0.001331762,04
AZ,2018,6.477017627792294e-4,264,407595,0.001371931,9839,7171646,1,Optional,2018,9575,6764051,0.001415572,0,0,0,0.001371931,04
AZ,2019,6.642335590117171e-4,275,414011,0.001400247,10192,7278717,1,Optional,2019,9917,6864706,0.001444636,0,0,0,0.001400247,04
AZ,2020,0.001050912,442,420587,0.001613981,11978,7421401,1,Optional,2020,11536,7000814,0.001647808,0,0,0,0.001613981,04
CA,1999,8.829456833889222e-5,40,453029,1.8767610119930014e-4,6287,33499204,1,Mandatory,1999,6247,33046175,1.8903851958660873e-4,1,0,1,1.8767610119930014e-4,06
CA,2000,9.943049596777606e-5,47,472692,1.6533001287684615e-4,5600,33871648,1,Mandatory,2000,5553,33398956,1.6626268198323326e-4,1,0,1,1.6533001287684615e-4,06
CA,2001,6.0598103279367356e-5,30,495065,1.3605202262750185e-4,4691,34479458,1,Mandatory,2001,4661,33984393,1.37151191724978e-4,1,0,1,1.3605202262750185e-4,06
CA,2002,1.1500952239859182e-4,59,513001,2.0084972279784581e-4,7004,34871843,1,Mandatory,2002,6945,34358842,2.0213137567325464e-4,1,0,1,2.0084972279784581e-4,06
CA,2003,1.3837155380035603e-4,74,534792,2.020528146144293e-4,7123,35253159,1,Mandatory,2003,7049,34718367,2.0303374291768964e-4,1,0,1,2.020528146144293e-4,06
CA,2004,1.5064292247269598e-4,84,557610,2.0345990912161538e-4,7238,35574576,1,Mandatory,2004,7154,35016966,2.0430096656574986e-4,1,0,1,2.0345990912161538e-4,06
CA,2005,1.3404894848911367e-4,78,581877,2.0774287823333872e-4,7443,35827943,1,Mandatory,2005,7365,35246066,2.0895949068471925e-4,1,0,1,2.0774287823333872e-4,06
CA,2006,1.2514243184677298e-4,76,607308,2.0643397741141453e-4,7436,36021202,1,Mandatory,2006,7360,35413894,2.0782803495147977e-4,1,0,1,2.0643397741141453e-4,06
CA,2007,1.4614529985715476e-4,93,636353,2.1197059523158298e-4,7684,36250311,1,Mandatory,2007,7591,35613958,2.131467667817208e-4,1,0,1,2.1197059523158298e-4,06
CA,2008,1.44848111076102e-4,97,669667,2.067241376342918e-4,7567,36604337,1,Mandatory,2008,7470,35934670,2.078772394459167e-4,1,0,1,2.067241376342918e-4,06
CA,2009,1.3534871327080034e-4,96,709279,2.1022028244785908e-4,7770,36961229,1,Mandatory,2009,7674,36251950,2.1168516452218432e-4,1,0,1,2.1022028244785908e-4,06
CA,2010,1.3660795680483457e-4,101,739342,2.033877959162243e-4,7577,37253956,1,Mandatory,2010,7476,36514614,2.0473994330050976e-4,1,0,1,2.033877959162243e-4,06
CA,2011,1.4277385810658068e-4,108,756441,2.0590624322799013e-4,7761,37691912,1,Mandatory,2011,7653,36935471,2.0719919884059417e-4,1,0,1,2.0590624322799013e-4,06
CA,2012,1.4990295755905387e-4,114,760492,2.0254233345066156e-4,7705,38041430,1,Mandatory,2012,7591,37280938,2.036161214613216e-4,1,0,1,2.0254233345066156e-4,06
CA,2013,1.5194144491074749e-4,116,763452,2.1561326477848925e-4,8265,38332521,1,Mandatory,2013,8149,37569069,2.1690715838606489e-4,1,0,1,2.1561326477848925e-4,06
CA,2014,1.7436337848564105e-4,134,768510,2.156046646478964e-4,8366,38802500,1,Mandatory,2014,8232,38033990,2.1643798086921724e-4,1,0,1,2.156046646478964e-4,06
CA,2015,1.9282808922893352e-4,149,772709,2.2363113298930142e-4,8754,39144818,1,Mandatory,2015,8605,38372109,2.2425142178137772e-4,1,0,1,2.2363113298930142e-4,06
CA,2016,1.9525315023501496e-4,151,773355,2.31821555644167e-4,9099,39250017,1,Mandatory,2016,8948,38476662,2.3255655597151332e-4,1,0,1,2.31821555644167e-4,06
CA,2017,1.9184664628886183e-4,149,776662,2.3861402734318458e-4,9434,39536653,1,Mandatory,2017,9285,38759991,2.395511392146608e-4,1,0,1,2.3861402734318458e-4,06
CA,2018,2.1723509850776198e-4,169,777959,2.503725948184451e-4,9904,39557045,1,Mandatory,2018,9735,38779086,2.510373761774581e-4,1,0,1,2.503725948184451e-4,06
CA,2019,2.2402933496763161e-4,174,776684,2.787998032912499e-4,11016,39512223,1,Mandatory,2019,10842,38735539,2.798980027101211e-4,1,0,1,2.787998032912499e-4,06
CA,2020,3.103557028174518e-4,247,795861,3.605205212202638e-4,14193,39368078,1,Mandatory,2020,13946,38572217,3.6155557249924214e-4,1,0,1,3.605205212202638e-4,06
CO,1999,9.422051369024064e-5,5,53067,3.4003641252829494e-4,1437,4226018,0,No,1999,1432,4172951,3.431624286985397e-4,0,0,,0,08
CO,2000,2.436562358592363e-4,14,57458,3.345530531627818e-4,1439,4301261,0,No,2000,1425,4243803,3.357837298291179e-4,0,0,0,0,08
CO,2001,1.9629653863770203e-4,12,61132,3.470647607930701e-4,1536,4425687,0,No,2001,1524,4364555,3.491764910741187e-4,0,0,0,0,08
CO,2002,1.8785516366881134e-4,12,63879,3.6143725088555467e-4,1623,4490406,0,No,2002,1611,4426527,3.6394220570664087e-4,0,0,0,0,08
CO,2003,2.729671529525947e-4,18,65942,3.731728881285093e-4,1690,4528732,0,No,2003,1672,4462790,3.7465352391665303e-4,0,0,0,0,08
CO,2004,1.8867650687217892e-4,13,68901,3.595618198243371e-4,1645,4575013,0,No,2004,1632,4506112,3.621747528689922e-4,0,0,0,0,08
CO,2005,2.2213275208596538e-4,16,72029,3.976780094855489e-4,1842,4631888,0,No,2005,1826,4559859,4.004509788570217e-4,0,0,0,0,08
CO,2006,2.915645086475383e-4,22,75455,3.946680202176796e-4,1863,4720423,0,No,2006,1841,4644968,3.963428811565548e-4,0,0,0,0,08
CO,2007,2.3968412155769448e-4,19,79271,4.140413516774399e-4,1989,4803868,0,No,2007,1970,4724597,4.169667804470942e-4,0,0,0,0,08
CO,2008,2.9720861667221457e-4,25,84116,4.302896069926151e-4,2104,4889730,0,No,2008,2079,4805614,4.326190160091926e-4,0,0,0,0,08
CO,2009,3.3847056434325426e-4,30,88634,4.291867072791795e-4,2134,4972195,0,No,2009,2104,4883561,4.308331563791258e-4,0,0,0,0,08
CO,2010,1.2902809586787524e-4,12,93003,4.016546581203039e-4,2020,5029196,0,No,2010,2008,4936193,4.0679122554567864e-4,0,0,0,0,08
CO,2011,2.2928130732032684e-4,22,95952,3.998595996400873e-4,2046,5116796,0,No,2011,2024,5020844,4.0311947553040885e-4,0,0,0,0,08
CO,2012,3.9080176066477436e-4,38,97236,9.927553916256168e-4,5150,5187582,0,No,2012,5112,5090346,0.001004254,0,0,0,0,08
CO,2013,4.427450191185349e-4,44,99380,0.001082119,5701,5268367,0,No,2013,5657,5168987,0.001094412,0,0,0,0,08
CO,2014,6.623040272038908e-4,67,101162,9.074162796455326e-4,4860,5355866,0,No,2014,4793,5254704,9.121351078957064e-4,0,0,0,0,08
CO,2015,4.746452269094784e-4,49,103235,0.001155853,6307,5456574,0,No,2015,6258,5353339,0.00116899,0,0,0,0,08
CO,2016,5.702771546971828e-4,60,105212,0.001218472,6751,5540545,0,No,2016,6691,5435333,0.001231019,0,0,0,0,08
CO,2017,5.735292734982465e-4,61,106359,0.001265169,7094,5607154,0,No,2017,7033,5500795,0.001278542,0,0,0,0,08
CO,2018,7.36078907658901e-4,80,108684,0.001250974,7125,5695564,0,No,2018,7045,5586880,0.00126099,0,0,0,0,08
CO,2019,7.492259502983364e-4,83,110781,0.001298722,7479,5758736,0,No,2019,7396,5647955,0.001309501,0,0,0,0,08
CO,2020,6.984886451939616e-4,80,114533,0.001413119,8207,5807719,0,No,2020,8127,5693186,0.001427496,0,0,0,0,08
CT,1999,0,0,11760,1.3879041495676382e-4,470,3386401,0,No,1999,470,3374641,1.3927407389408236e-4,0,0,0,0,09
CT,2000,3.898027598035394e-4,5,12827,1.5797672339244736e-4,538,3405565,0,No,2000,533,3392738,1.5710025354153488e-4,0,0,0,0,09
CT,2001,3.6963110815406224e-4,5,13527,1.5380873243252299e-4,528,3432835,0,No,2001,523,3419308,1.529549253825628e-4,0,0,0,0,09
CT,2002,3.5278346151132434e-4,5,14173,1.6161912876592086e-4,559,3458749,0,No,2002,554,3444576,1.608325669109928e-4,0,0,0,0,09
CT,2003,3.329781566329249e-4,5,15016,1.4837834238718654e-4,517,3484336,0,No,2003,512,3469320,1.4757935272618266e-4,0,0,0,0,09
CT,2004,3.215434083601286e-4,5,15550,5.609116917336891e-4,1961,3496094,0,No,2004,1956,3480544,5.61981115595723e-4,0,0,0,0,09
CT,2005,3.0894710825506676e-4,5,16184,9.475453926425082e-4,3323,3506956,0,No,2005,3318,3490772,9.505060771657387e-4,0,0,0,0,09
CT,2006,2.955781508630882e-4,5,16916,0.001055023,3711,3517460,0,No,2006,3706,3500544,0.001058693,0,0,0,0,09
CT,2007,2.836718484057642e-4,5,17626,0.00110964,3914,3527270,0,No,2007,3909,3509644,0.001113788,0,0,0,0,09
CT,2008,2.711790866688361e-4,5,18438,0.001064424,3774,3545579,0,No,2008,3769,3527141,0.001068571,0,0,0,0,09
CT,2009,2.596323605774224e-4,5,19258,0.001005669,3582,3561807,0,No,2009,3577,3542549,0.001009725,0,0,0,0,09
CT,2010,2.498126405196103e-4,5,20015,9.669575280133695e-4,3456,3574097,0,No,2010,3451,3554082,9.70996167224054e-4,0,0,0,0,09
CT,2011,2.449179524859172e-4,5,20415,9.86117553814063e-4,3531,3580709,0,No,2011,3526,3560294,9.903676494132227e-4,0,0,0,0,09
CT,2012,2.3742817797616221e-4,5,21059,9.380708884127356e-4,3368,3590347,0,No,2012,3363,3569288,9.422047198208718e-4,0,0,0,0,09
CT,2013,2.2843567251461987e-4,5,21888,0.001021112,3672,3596080,0,No,2013,3667,3574192,0.001025966,0,0,0,0,09
CT,2014,2.2827923115554947e-4,5,21903,9.78959189273877e-4,3521,3596677,0,No,2014,3516,3574774,9.835586809124157e-4,0,0,0,0,09
CT,2015,2.2143489813994686e-4,5,22580,0.001058513,3801,3590886,0,No,2015,3796,3568306,0.00106381,0,0,0,0,09
CT,2016,2.2062392445836826e-4,5,22663,0.001108641,3965,3576452,0,No,2016,3960,3553789,0.001114304,0,0,0,0,09
CT,2017,2.1705157145337733e-4,5,23036,0.001116721,4007,3588184,0,No,2017,4002,3565148,0.001122534,0,0,0,0,09
CT,2018,2.12422465799983e-4,5,23538,0.001059433,3785,3572665,0,No,2018,3780,3549127,0.001065051,0,0,0,0,09
CT,2019,2.0609208194221178e-4,5,24261,0.001120527,3995,3565287,0,No,2019,3990,3541026,0.001126792,0,0,0,0,09
CT,2020,1.882813676758548e-4,5,26556,0.001134662,4036,3557006,0,No,2020,4031,3530450,0.001141781,0,0,0,0,09
FL,1999,8.208428414295799e-5,5,60913,1.0622217656346639e-4,1674,15759421,1,Optional,1999,1669,15698508,1.0631583587433915e-4,0,1,1,1.0622217656346639e-4,12
FL,2000,7.531481593058986e-5,5,66388,1.4653639151820838e-4,2342,15982378,1,Optional,2000,2337,15915990,1.4683346747516177e-4,0,1,1,1.4653639151820838e-4,12
FL,2001,7.097836579410595e-5,5,70444,1.8340809658710545e-4,3000,16356966,1,Optional,2001,2995,16286522,1.8389438825551583e-4,0,1,1,1.8340809658710545e-4,12
FL,2002,6.710958996040534e-5,5,74505,1.915590582508507e-4,3197,16689370,1,Optional,2002,3192,16614865,1.9211711921824222e-4,0,1,1,1.915590582508507e-4,12
FL,2003,6.38643011329527e-5,5,78291,2.0406861057210664e-4,3470,17004085,1,Optional,2003,3465,16925794,2.0471713173396769e-4,0,1,1,2.0406861057210664e-4,12
FL,2004,1.7076919323753996e-4,14,81982,2.2623761449546887e-4,3940,17415318,1,Optional,2004,3926,17333336,2.2649996515385152e-4,0,1,1,2.2623761449546887e-4,12
FL,2005,3.4987462825820747e-4,30,85745,0.001173857,20944,17842038,1,Optional,2005,20914,17756293,0.001177836,0,1,1,0.001173857,12
FL,2006,4.5577331391664905e-4,41,89957,0.001163649,21140,18166990,1,Optional,2006,21099,18077033,0.001167172,0,1,1,0.001163649,12
FL,2007,3.3275369785964234e-4,31,93162,0.001152013,21160,18367842,1,Optional,2007,21129,18274680,0.00115619,0,1,1,0.001152013,12
FL,2008,4.1822630225214866e-4,40,95642,0.001168546,21650,18527305,1,Optional,2008,21610,18431663,0.001172439,0,1,1,0.001168546,12
FL,2009,3.179878549154768e-4,31,97488,0.001138659,21239,18652644,1,Optional,2009,21208,18555156,0.001142971,0,1,1,0.001138659,12
FL,2010,4.3290914948453606e-4,43,99328,0.001114071,20946,18801310,1,Optional,2010,20903,18701982,0.001117689,0,1,1,0.001114071,12
FL,2011,2.983121307184511e-4,31,103918,0.001088808,20750,19057542,1,Optional,2011,20719,18953624,0.001093142,0,1,1,0.001088808,12
FL,2012,3.49102711678901e-4,37,105986,0.001093305,21120,19317568,1,Optional,2012,21083,19211582,0.001097411,0,1,1,0.001093305,12
FL,2013,4.449388209121246e-4,48,107880,0.001154921,22582,19552860,1,Optional,2013,22534,19444980,0.00115886,0,1,1,0.001154921,12
FL,2014,4.348613879325965e-4,48,110380,0.00111339,22149,19893297,1,Optional,2014,22101,19782917,0.001117176,0,1,1,0.00111339,12
FL,2015,5.237600646266656e-4,59,112647,0.001119959,22703,20271272,1,Optional,2015,22644,20158625,0.001123291,0,1,1,0.001119959,12
FL,2016,5.59117991368616e-4,64,114466,0.001217954,25105,20612439,1,Optional,2016,25041,20497973,0.001221633,0,1,1,0.001217954,12
FL,2017,4.7934535120606716e-4,56,116826,0.001260746,26456,20984400,1,Optional,2017,26400,20867574,0.001265121,0,1,1,0.001260746,12
FL,2018,3.7610323615940093e-4,45,119648,0.001242997,26475,21299325,1,Optional,2018,26430,21179677,0.001247894,0,1,1,0.001242997,12
FL,2019,4.3512885561110975e-4,53,121803,0.001227178,26357,21477737,1,Optional,2019,26304,21355934,0.001231695,0,1,1,0.001227178,12
FL,2020,4.095358855819741e-4,52,126973,0.001359802,29553,21733312,1,Optional,2020,29501,21606339,0.001365386,0,1,1,0.001359802,12
IA,1999,0,0,8532,5.8951876760416146e-5,172,2917634,1,Optional,1999,172,2909102,5.912477458679689e-5,0,0,0,5.8951876760416146e-5,19
IA,2000,4.760544606302961e-4,5,10503,1.219960605865926e-4,357,2926324,1,Optional,2000,352,2915821,1.2072071639514222e-4,0,0,0,1.219960605865926e-4,19
IA,2001,4.587997797761057e-4,5,10898,1.2926343376204e-4,379,2931997,1,Optional,2001,374,2921099,1.280340036404107e-4,0,0,0,1.2926343376204e-4,19
IA,2002,0,0,11386,1.3700338827782652e-4,402,2934234,1,Optional,2002,402,2922848,1.37537087115033e-4,0,0,0,1.3700338827782652e-4,19
IA,2003,4.2319085907744394e-4,5,11815,1.7097218591848604e-4,503,2941999,1,Optional,2003,498,2930184,1.6995519735279422e-4,0,0,0,1.7097218591848604e-4,19
IA,2004,4.0591005033284623e-4,5,12318,1.89258320679434e-4,559,2953635,1,Optional,2004,554,2941317,1.8835100058919185e-4,0,0,0,1.89258320679434e-4,19
IA,2005,0,0,12699,1.9463955251118755e-4,577,2964454,1,Optional,2005,577,2951755,1.9547692813258553e-4,0,0,0,1.9463955251118755e-4,19
IA,2006,3.775579551461149e-4,5,13243,1.968052506433889e-4,587,2982644,1,Optional,2006,582,2969401,1.9599912574960404e-4,0,0,0,1.968052506433889e-4,19
IA,2007,3.594536304816679e-4,5,13910,2.2139148549685716e-4,664,2999212,1,Optional,2007,659,2985302,2.2074818561070204e-4,0,0,0,2.2139148549685716e-4,19
IA,2008,3.459010722933241e-4,5,14455,2.3435940987836515e-4,707,3016734,1,Optional,2008,702,3002279,2.3382237293735858e-4,0,0,0,2.3435940987836515e-4,19
IA,2009,3.322700691121744e-4,5,15048,2.331125303755189e-4,707,3032870,1,Optional,2009,702,3017822,2.326180934462006e-4,0,0,0,2.331125303755189e-4,19
IA,2010,3.240860772621208e-4,5,15428,2.416002074610477e-4,736,3046355,1,Optional,2010,731,3030927,2.4118033855648782e-4,0,0,0,2.416002074610477e-4,19
IA,2011,7.538161944845782e-4,12,15919,0.00151389,4636,3062309,1,Optional,2011,4624,3046390,0.001517862,0,0,0,0.00151389,19
IA,2012,9.334743916858548e-4,15,16069,0.001616688,4970,3074186,1,Optional,2012,4955,3058117,0.001620278,0,0,0,0.001616688,19
IA,2013,2.981159074648223e-4,5,16772,0.001695241,5239,3090416,1,Optional,2013,5234,3073644,0.001702865,0,0,0,0.001695241,19
IA,2014,6.950880444856349e-4,12,17264,0.001653296,5137,3107126,1,Optional,2014,5125,3089862,0.00165865,0,0,0,0.001653296,19
IA,2015,6.765518407848001e-4,12,17737,0.001689875,5279,3123899,1,Optional,2015,5267,3106162,0.001695662,0,0,0,0.001689875,19
IA,2016,8.878530603185173e-4,16,18021,0.001717553,5384,3134693,1,Optional,2016,5368,3116672,0.00172235,0,0,0,0.001717553,19
IA,2017,8.163265306122449e-4,15,18375,0.001809766,5693,3145711,1,Optional,2017,5678,3127336,0.001815603,0,0,0,0.001809766,19
IA,2018,0.001218737,23,18872,0.001856379,5859,3156145,1,Optional,2018,5836,3137273,0.001860214,0,0,0,0.001856379,19
IA,2019,0.001089268,21,19279,0.001906455,6015,3155070,1,Optional,2019,5994,3135791,0.001911479,0,0,0,0.001906455,19
IA,2020,0.00120597,24,19901,0.00197657,6253,3163561,1,Optional,2020,6229,3143660,0.001981448,0,0,0,0.00197657,19
ID,1999,2.58732212160414e-4,5,19325,8.779672549569874e-5,112,1275674,1,Optional,1999,107,1256349,8.516741765226064e-5,0,0,0,8.779672549569874e-5,16
ID,2000,0,0,20595,1.646118522079241e-4,213,1293953,1,Optional,2000,213,1273358,1.672742465198318e-4,0,0,0,1.646118522079241e-4,16
ID,2001,2.3420300716661202e-4,5,21349,1.666714647845923e-4,220,1319962,1,Optional,2001,215,1298613,1.655612565098301e-4,0,0,0,1.666714647845923e-4,16
ID,2002,2.2672652246859837e-4,5,22053,2.0292873918583795e-4,272,1340372,1,Optional,2002,267,1318319,2.0253064698301398e-4,0,0,0,2.0292873918583795e-4,16
ID,2003,8.365253379122089e-4,19,22713,0.001312913,1790,1363380,1,Optional,2003,1771,1340667,0.001320984,0,0,0,0.001312913,16
ID,2004,6.819828651805123e-4,16,23461,0.001340708,1866,1391802,1,Optional,2004,1850,1368341,0.001352002,0,0,0,0.001340708,16
ID,2005,0.001094713,27,24664,0.001490645,2129,1428241,1,Optional,2005,2102,1403577,0.001497602,0,0,0,0.001490645,16
ID,2006,6.61916442783164e-4,17,25683,0.001427823,2097,1468669,1,Optional,2006,2080,1442986,0.001441455,0,0,0,0.001427823,16
ID,2007,8.203445447087777e-4,22,26818,0.001395916,2101,1505105,1,Optional,2007,2079,1478287,0.001406357,0,0,0,0.001395916,16
ID,2008,8.213992357415807e-4,23,28001,0.00141887,2177,1534320,1,Optional,2008,2154,1506319,0.001429976,0,0,0,0.00141887,16
ID,2009,9.679203539823009e-4,28,28928,0.001509869,2347,1554439,1,Optional,2009,2319,1525511,0.001520146,0,0,0,0.001509869,16
ID,2010,6.040065769605047e-4,18,29801,0.00151571,2376,1567582,1,Optional,2010,2358,1537781,0.001533378,0,0,0,0.00151571,16
ID,2011,8.152351138068219e-4,25,30666,0.001550803,2458,1584985,1,Optional,2011,2433,1554319,0.001565316,0,0,0,0.001550803,16
ID,2012,8.402546617974987e-4,26,30943,0.001472055,2349,1595728,1,Optional,2012,2323,1564785,0.001484549,0,0,0,0.001472055,16
ID,2013,0.001195269,38,31792,0.001574309,2538,1612136,1,Optional,2013,2500,1580344,0.001581934,0,0,0,0.001574309,16
ID,2014,8.26648704917029e-4,27,32662,0.00155525,2542,1634464,1,Optional,2014,2515,1601802,0.001570107,0,0,0,0.00155525,16
ID,2015,8.680035917390003e-4,29,33410,0.001580127,2615,1654930,1,Optional,2015,2586,1621520,0.0015948,0,0,0,0.001580127,16
ID,2016,9.936290841077795e-4,34,34218,0.00165821,2791,1683140,1,Optional,2016,2757,1648922,0.001672001,0,0,0,0.00165821,16
ID,2017,0.001033532,36,34832,0.001711181,2938,1716943,1,Optional,2017,2902,1682111,0.001725213,0,0,0,0.001711181,16
ID,2018,0.00123839,44,35530,0.00167426,2937,1754208,1,Optional,2018,2893,1718678,0.001683271,0,0,0,0.00167426,16
ID,2019,0.001378322,50,36276,0.001647394,2944,1787065,1,Optional,2019,2894,1750789,0.001652969,0,0,0,0.001647394,16
ID,2020,0.001022577,38,37161,0.001655799,3025,1826913,1,Optional,2020,2987,1789752,0.001668946,0,0,0,0.001655799,16
IN,1999,0,0,17099,8.387139785166806e-5,507,6044969,0,No,1999,507,6027870,8.410931224462373e-5,0,0,0,0,18
IN,2000,2.5412960609911054e-4,5,19675,1.174248435774449e-4,714,6080485,0,No,2000,709,6060810,1.169810635872103e-4,0,0,0,0,18
IN,2001,0,0,20272,1.2549447106283536e-4,769,6127760,0,No,2001,769,6107488,1.259110128419409e-4,0,0,0,0,18
IN,2002,0,0,21238,1.262190001993188e-4,777,6155967,0,No,2002,777,6134729,1.266559614939796e-4,0,0,0,0,18
IN,2003,0,0,21975,1.5556822909455095e-4,964,6196638,0,No,2003,964,6174663,1.5612188065972183e-4,0,0,0,0,18
IN,2004,2.1880880486630782e-4,5,22851,1.8113247747034457e-4,1129,6233007,0,No,2004,1124,6210156,1.8099384298880737e-4,0,0,0,0,18
IN,2005,0,0,23684,1.9446960922598228e-4,1221,6278616,0,No,2005,1221,6254932,1.9520595907357587e-4,0,0,0,0,18
IN,2006,2.0119105102205055e-4,5,24852,2.0417931207205052e-4,1293,6332669,0,No,2006,1288,6307817,2.0419108544207924e-4,0,0,0,0,18
IN,2007,1.9386607731379163e-4,5,25791,2.1756853369624016e-4,1388,6379599,0,No,2007,1383,6353808,2.1766474529919696e-4,0,0,0,0,18
IN,2008,4.446585392966984e-4,12,26987,0.001179491,7578,6424806,0,No,2008,7566,6397819,0.001182591,0,0,0,0,18
IN,2009,1.7785998861696072e-4,5,28112,0.001189753,7685,6459325,0,No,2009,7680,6431213,0.001194176,0,0,0,0,18
IN,2010,1.722415515518964e-4,5,29029,0.001251735,8116,6483802,0,No,2010,8111,6454773,0.00125659,0,0,0,0,18
IN,2011,1.689246258319538e-4,5,29599,0.001618249,10546,6516922,0,No,2011,10541,6487323,0.001624861,0,0,0,0,18
IN,2012,4.965736418710895e-4,15,30207,0.001657709,10837,6537334,0,No,2012,10822,6507127,0.0016631,0,0,0,0,18
IN,2013,3.901043529144046e-4,12,30761,0.001703571,11194,6570902,0,No,2013,11182,6540141,0.001709749,0,0,0,0,18
IN,2014,1.6060129123438152e-4,5,31133,0.00175038,11547,6596855,0,No,2014,11542,6565722,0.001757918,0,0,0,0,18
IN,2015,5.377024291497975e-4,17,31616,0.001793893,11875,6619680,0,No,2015,11858,6588064,0.001799922,0,0,0,0,18
IN,2016,5.328652477823402e-4,17,31903,0.001776859,11786,6633053,0,No,2016,11769,6601150,0.001782871,0,0,0,0,18
IN,2017,4.0109839252105766e-4,13,32411,0.001837308,12249,6666818,0,No,2017,12236,6634407,0.001844325,0,0,0,0,18
IN,2018,3.6365840353960846e-4,12,32998,0.001833118,12267,6691878,0,No,2018,12255,6658880,0.0018404,0,0,0,0,18
IN,2019,3.5666518056174767e-4,12,33645,0.001823024,12273,6732219,0,No,2019,12261,6698574,0.00183039,0,0,0,0,18
IN,2020,6.604450825556354e-4,23,34825,0.002006232,13552,6754953,0,No,2020,13529,6720128,0.002013206,0,0,0,0,18
KS,1999,1.7524797588587852e-4,5,28531,8.17671257324505e-5,219,2678338,0,No,1999,214,2649807,8.076059879077985e-5,0,1,1,0,20
KS,2000,1.6169194450732464e-4,5,30923,1.201450072124201e-4,323,2688418,0,No,2000,318,2657495,1.1966156098130006e-4,0,1,1,0,20
KS,2001,1.580927688367534e-4,5,31627,1.4543909654565494e-4,393,2702162,0,No,2001,388,2670535,1.4528923979652018e-4,0,1,1,0,20
KS,2002,1.5355322154658805e-4,5,32562,1.5625374281149864e-4,424,2713535,0,No,2002,419,2680973,1.562865422367178e-4,0,1,1,0,20
KS,2003,1.4992054211268027e-4,5,33351,1.674621116972285e-4,456,2723004,0,No,2003,451,2689653,1.6767962261302852e-4,0,1,1,0,20
KS,2004,1.4620310535395773e-4,5,34199,1.9163442588118008e-4,524,2734373,0,No,2004,519,2700174,1.9220983536616528e-4,0,1,1,0,20
KS,2005,0.001930886,68,35217,0.00150184,4123,2745299,0,No,2005,4055,2710082,0.001496265,0,1,1,0,20
KS,2006,0.001497047,54,36071,0.00138259,3820,2762931,0,No,2006,3766,2726860,0.001381076,0,1,1,0,20
KS,2007,0.001517533,56,36902,0.001330563,3704,2783785,0,No,2007,3648,2746883,0.001328051,0,1,1,0,20
KS,2008,0.001051608,40,38037,0.001344693,3776,2808076,0,No,2008,3736,2770039,0.001348717,0,1,1,0,20
KS,2009,0.001009591,40,39620,0.001307232,3703,2832704,0,No,2009,3663,2793084,0.001311454,0,1,1,0,20
KS,2010,0.001795332,73,40661,0.001299631,3708,2853118,0,No,2010,3635,2812457,0.001292464,0,1,1,0,20
KS,2011,0.0011071,46,41550,0.001281329,3679,2871238,0,No,2011,3633,2829688,0.001283887,0,1,1,0,20
KS,2012,0.001317744,55,41738,0.00135798,3919,2885905,0,No,2012,3864,2844167,0.00135857,0,1,1,0,20
KS,2013,0.00125649,53,42181,0.00131239,3798,2893957,0,No,2013,3745,2851776,0.001313217,0,1,1,0,20
KS,2014,0.001454443,62,42628,0.001397028,4057,2904021,0,No,2014,3995,2861393,0.001396173,0,1,1,0,20
KS,2015,0.001497812,64,42729,0.001482669,4317,2911641,0,No,2015,4253,2868912,0.001482444,0,1,1,0,20
KS,2016,0.00131681,56,42527,0.001521349,4423,2907289,0,No,2016,4367,2864762,0.001524385,0,1,1,0,20
KS,2017,0.001710563,73,42676,0.001726669,5030,2913123,0,No,2017,4957,2870447,0.001726909,0,1,1,0,20
KS,2018,0.00151367,65,42942,0.001716294,4997,2911505,0,No,2018,4932,2868563,0.001719328,0,1,1,0,20
KS,2019,0.001435883,62,43179,0.001779074,5183,2913314,0,No,2019,5121,2870135,0.001784237,0,1,1,0,20
KS,2020,0.00237584,104,43774,0.001914679,5579,2913805,0,No,2020,5475,2870031,0.001907645,0,1,1,0,20
LA,1999,0,0,25856,9.594667875415479e-5,428,4460811,0,No,1999,428,4434955,9.65060524853127e-5,0,0,0,0,22
LA,2000,1.76934781839414e-4,5,28259,6.578688272212695e-4,2940,4468976,0,No,2000,2935,4440717,6.609293048847742e-4,0,0,0,0,22
LA,2001,1.733042182246716e-4,5,28851,6.239566758786255e-4,2794,4477875,0,No,2001,2789,4449024,6.268790638126474e-4,0,0,0,0,22
LA,2002,1.6813504606900262e-4,5,29738,6.381653568711842e-4,2870,4497267,0,No,2002,2865,4467529,6.412941023997829e-4,0,0,0,0,22
LA,2003,1.6371971185330714e-4,5,30540,6.392331679289863e-4,2890,4521042,0,No,2003,2885,4490502,6.424671450986994e-4,0,0,0,0,22
LA,2004,1.5867474850052364e-4,5,31511,6.038787954408359e-4,2749,4552238,0,No,2004,2744,4520727,6.069820186001057e-4,0,0,0,0,22
LA,2005,1.5436386650612824e-4,5,32391,6.649000093518634e-4,3043,4576628,0,No,2005,3038,4544237,6.685390748765965e-4,0,0,0,0,22
LA,2006,1.5872008126468161e-4,5,31502,6.203132244783175e-4,2669,4302665,0,No,2006,2664,4271163,6.237177087364729e-4,0,0,0,0,22
LA,2007,1.5299409442795509e-4,5,32681,6.047196932247397e-4,2646,4375581,0,No,2007,2641,4342900,6.081189988256695e-4,0,0,0,0,22
LA,2008,1.467222254827161e-4,5,34078,5.821102330109257e-4,2582,4435586,0,No,2008,2577,4401508,5.854811578213648e-4,0,0,0,0,22
LA,2009,1.4215045203843748e-4,5,35174,5.975535037473996e-4,2684,4491648,0,No,2009,2679,4456474,6.011479030282685e-4,0,0,0,0,22
LA,2010,1.3831641262552214e-4,5,36149,5.684510338000059e-4,2577,4533372,0,No,2010,2572,4497223,5.719084866371981e-4,0,0,0,0,22
LA,2011,1.3603221242790292e-4,5,36756,5.128052677735333e-4,2346,4574836,0,No,2011,2341,4538080,5.158569262771921e-4,0,0,0,0,22
LA,2012,2.6674491184080666e-4,10,37489,7.635988059696303e-4,3514,4601893,0,No,2012,3504,4564404,7.676796357202387e-4,0,0,0,0,22
LA,2013,6.029149627765545e-4,23,38148,0.00123555,5715,4625470,0,No,2013,5692,4587322,0.001240811,0,0,0,0,22
LA,2014,4.392878368950102e-4,17,38699,0.001308908,6086,4649676,0,No,2014,6069,4610977,0.001316207,0,0,0,0,22
LA,2015,6.144865197019741e-4,24,39057,0.001384582,6467,4670724,0,No,2015,6443,4631667,0.001391076,0,0,0,0,22
LA,2016,5.827653482656397e-4,23,39467,0.001413813,6619,4681666,0,No,2016,6596,4642199,0.001420878,0,0,0,0,22
LA,2017,5.239390234774581e-4,21,40081,0.001462535,6851,4684333,0,No,2017,6830,4644252,0.001470635,0,0,0,0,22
LA,2018,4.7451362353587574e-4,19,40041,0.001475758,6877,4659978,0,No,2018,6858,4619937,0.001484436,0,0,0,0,22
LA,2019,7.227594457182734e-4,29,40124,0.001605363,7463,4648794,0,No,2019,7434,4608670,0.001613047,0,0,0,0,22
LA,2020,0.00100653,41,40734,0.001794926,8338,4645318,0,No,2020,8297,4604584,0.0018019,0,0,0,0,22
MA,1999,2.536912070627632e-4,5,19709,1.0320791408416035e-4,652,6317345,0,No,1999,647,6297636,1.0273696352091483e-4,0,0,2,0,25
MA,2000,0,0,20760,1.1434696934067947e-4,726,6349097,0,No,2000,726,6328337,1.147220825945268e-4,0,0,2,0,25
MA,2001,0,0,22400,1.5114962812814861e-4,967,6397634,0,No,2001,967,6375234,1.5168070693561994e-4,0,0,2,0,25
MA,2002,0,0,23692,1.492861535066819e-4,958,6417206,0,No,2002,958,6393514,1.4983935281912263e-4,0,0,2,0,25
MA,2003,1.996087668170386e-4,5,25049,1.7718777466635215e-4,1138,6422565,0,No,2003,1133,6397516,1.7709998693242815e-4,0,0,2,0,25
MA,2004,1.895159761967934e-4,5,26383,1.5407933619877233e-4,988,6412281,0,No,2004,983,6385898,1.5393293159395905e-4,0,0,2,0,25
MA,2005,1.803491559659501e-4,5,27724,1.822500620774633e-4,1167,6403290,0,No,2005,1162,6375566,1.8225832812333837e-4,0,0,2,0,25
MA,2006,1.7188037126160193e-4,5,29090,2.1778185746083826e-4,1396,6410084,0,No,2006,1391,6380994,2.1799111549078404e-4,0,0,2,0,25
MA,2007,1.6375188314665619e-4,5,30534,2.1736564960377414e-4,1398,6431559,0,No,2007,1393,6401025,2.1762139657320508e-4,0,0,2,0,25
MA,2008,1.5559358954411078e-4,5,32135,2.0049568965184087e-4,1297,6468967,0,No,2008,1292,6436832,2.0071985722168917e-4,0,0,2,0,25
MA,2009,1.4758404911597155e-4,5,33879,1.97618361200642e-4,1288,6517613,0,No,2009,1283,6483734,1.9787980197830447e-4,0,0,2,0,25
MA,2010,1.422717960391532e-4,5,35144,1.8999243848422077e-4,1244,6547629,0,No,2010,1239,6512485,1.9024995834923228e-4,0,0,2,0,25
MA,2011,1.3977412501397742e-4,5,35772,2.2906895689070998e-4,1509,6587536,0,No,2011,1504,6551764,2.2955649806678018e-4,0,0,2,0,25
MA,2012,1.3648523229786537e-4,5,36634,2.1681745084066792e-4,1441,6646144,0,No,2012,1436,6609510,2.1726270177365643e-4,0,0,2,0,25
MA,2013,1.333155579256099e-4,5,37505,2.556469436518875e-4,1711,6692824,0,No,2013,1706,6655319,2.563363228719765e-4,0,0,2,0,25
MA,2014,1.3015410245730946e-4,5,38416,4.067952598271298e-4,2744,6745408,0,No,2014,2739,6706992,4.083797923122616e-4,0,0,2,0,25
MA,2015,3.598601686201933e-4,14,38904,0.0010254,6967,6794422,0,No,2015,6953,6755518,0.001029233,0,0,2,0,25
MA,2016,3.8137855635503803e-4,15,39331,0.001160343,7904,6811779,0,No,2016,7889,6772448,0.001164867,0,0,2,0,25
MA,2017,6.008411776487082e-4,24,39944,0.001177291,8076,6859819,0,No,2017,8052,6819875,0.001180667,0,0,2,0,25
MA,2018,4.386178663677567e-4,18,41038,0.001179343,8140,6902149,0,No,2018,8122,6861111,0.001183773,0,0,2,0,25
MA,2019,3.3975634616318013e-4,14,41206,0.001200725,8276,6892503,0,No,2019,8262,6851297,0.001205903,0,0,2,0,25
MA,2020,3.2934202168952457e-4,14,42509,0.001266687,8732,6893574,0,No,2020,8718,6851065,0.001272503,0,0,2,0,25
ME,1999,6.600660066006601e-4,5,7575,2.0208271498127578e-4,256,1266808,0,No,1999,251,1259233,1.993276859802753e-4,0,1,2,0,23
ME,2000,6.078288353999514e-4,5,8226,2.0942441229784074e-4,267,1274923,0,No,2000,262,1266697,2.0683715205767442e-4,0,1,2,0,23
ME,2001,0,0,8441,2.2011492643650267e-4,283,1285692,0,No,2001,283,1277251,2.215696053477351e-4,0,1,2,0,23
ME,2002,5.757052389176742e-4,5,8685,2.5000771628753976e-4,324,1295960,0,No,2002,319,1287275,2.478102969450972e-4,0,1,2,0,23
ME,2003,5.590339892665474e-4,5,8944,2.3880359399408962e-4,312,1306513,0,No,2003,307,1297569,2.3659628119968956e-4,0,1,2,0,23
ME,2004,5.489076737292787e-4,5,9109,2.5120119845808134e-4,330,1313688,0,No,2004,325,1304579,2.491225138531281e-4,0,1,2,0,23
ME,2005,5.33731853116994e-4,5,9368,3.101334787194596e-4,409,1318787,0,No,2005,404,1309419,3.085337848312878e-4,0,1,2,0,23
ME,2006,5.225752508361204e-4,5,9568,2.9691323560631874e-4,393,1323619,0,No,2006,388,1314051,2.952701226969121e-4,0,1,2,0,23
ME,2007,5.075111652456354e-4,5,9852,2.7881601157463224e-4,370,1327040,0,No,2007,365,1317188,2.7710547013789984e-4,0,1,2,0,23
ME,2008,4.929022082018927e-4,5,10144,2.53286524179844e-4,337,1330509,0,No,2008,332,1320365,2.5144562299061243e-4,0,1,2,0,23
ME,2009,4.8049202383240437e-4,5,10406,3.151347407847532e-4,419,1329590,0,No,2009,414,1319184,3.1383036786377034e-4,0,1,2,0,23
ME,2010,4.762358319839985e-4,5,10499,2.476736369104483e-4,329,1328361,0,No,2010,324,1317862,2.4585275241261986e-4,0,1,2,0,23
ME,2011,4.722327162825841e-4,5,10588,3.071854285688472e-4,408,1328188,0,No,2011,403,1317600,3.0585913782635093e-4,0,1,2,0,23
ME,2012,9.449116507606539e-4,10,10583,0.001806361,2401,1329192,0,No,2012,2391,1318609,0.001813274,0,1,2,0,23
ME,2013,0.001854771,20,10783,0.002036434,2705,1328302,0,No,2013,2685,1317519,0.002037921,0,1,2,0,23
ME,2014,0.002199212,24,10913,0.001936713,2576,1330089,0,No,2014,2552,1319176,0.001934541,0,1,2,0,23
ME,2015,0.002640444,29,10983,0.00217704,2894,1329328,0,No,2015,2865,1318345,0.002173179,0,1,2,0,23
ME,2016,0.002242756,25,11147,0.002238113,2980,1331479,0,No,2016,2955,1320332,0.002238073,0,1,2,0,23
ME,2017,0.001675042,19,11343,0.002425319,3240,1335907,0,No,2017,3221,1324564,0.002431744,0,1,2,0,23
ME,2018,0.003218511,37,11496,0.002423782,3244,1338404,0,No,2018,3207,1326908,0.002416897,0,1,2,0,23
ME,2019,0.003003003,35,11655,0.002636489,3544,1344212,0,No,2019,3509,1332557,0.002633283,0,1,2,0,23
ME,2020,0.002426974,28,11537,0.002751564,3715,1350141,0,No,2020,3687,1338604,0.002754362,0,1,2,0,23
MI,1999,2.7966943073287376e-4,20,71513,1.1750897938348909e-4,1163,9897116,0,No,1999,1143,9825603,1.1632873829728313e-4,0,0,0,2,26
MI,2000,1.756163458291118e-4,13,74025,1.5253896887681815e-4,1516,9938444,0,No,2000,1503,9864419,1.523657906258848e-4,0,0,0,2,26
MI,2001,3.4689793195463644e-4,26,74950,1.6374540592045737e-4,1636,9991120,0,No,2001,1610,9916170,1.6236107287390193e-4,0,0,0,2,26
MI,2002,2.3665838362323986e-4,18,76059,1.8081593816114883e-4,1811,10015710,0,No,2002,1793,9939651,1.8038862732705605e-4,0,0,0,2,26
MI,2003,3.75925229768093e-4,29,77143,1.836442671119808e-4,1844,10041152,0,No,2003,1815,9964009,1.8215559620630612e-4,0,0,0,2,26
MI,2004,0.001162999,91,78246,0.001236659,12435,10055315,0,No,2004,12344,9977069,0.001237237,0,0,0,2,26
MI,2005,0.001474313,117,79359,0.001476251,14838,10051137,0,No,2005,14721,9971778,0.001476266,0,0,0,2,26
MI,2006,0.001626016,131,80565,0.001517923,15234,10036081,0,No,2006,15103,9955516,0.001517048,0,0,0,2,26
MI,2007,0.001399666,114,81448,0.001522505,15227,10001284,0,No,2007,15113,9919836,0.001523513,0,0,0,2,26
MI,2008,0.001333479,110,82491,0.001552345,15441,9946889,0,No,2008,15331,9864398,0.001554175,0,0,0,2,26
MI,2009,0.001738985,146,83957,0.001566617,15512,9901591,0,No,2009,15366,9817634,0.001565143,0,0,0,2,26
MI,2010,0.001423072,122,85730,0.001572093,15538,9883640,0,No,2010,15416,9797910,0.001573397,0,0,0,2,26
MI,2011,0.001681822,145,86216,0.001630589,16104,9876187,0,No,2011,15959,9789971,0.001630138,0,0,0,2,26
MI,2012,0.001821765,159,87278,0.001624346,16054,9883360,0,No,2012,15895,9796082,0.001622587,0,0,0,2,26
MI,2013,0.001925451,170,88291,0.001696811,16791,9895622,0,No,2013,16621,9807331,0.001694753,0,0,0,2,26
MI,2014,0.002080475,185,88922,0.001739376,17237,9909877,0,No,2014,17052,9820955,0.001736287,0,0,0,2,26
MI,2015,0.001864797,167,89554,0.001469981,14586,9922576,0,No,2015,14419,9833022,0.001466385,0,0,0,2,26
MI,2016,0.00225524,204,90456,0.001833446,18203,9928300,0,No,2016,17999,9837844,0.001829568,0,0,0,2,26
MI,2017,0.001856828,170,91554,0.001854991,18480,9962311,0,No,2017,18310,9870757,0.001854974,0,0,0,2,26
MI,2018,0.002007705,185,92145,0.001840352,18396,9995915,0,No,2018,18211,9903770,0.001838795,0,0,0,2,26
MI,2019,0.001737348,161,92670,0.001828703,18263,9986857,0,No,2019,18102,9894187,0.001829559,0,0,0,2,26
MI,2020,0.001842672,171,92800,0.002055776,20489,9966555,0,No,2020,20318,9873755,0.002057778,0,0,0,2,26
MN,1999,2.168292886331415e-4,13,59955,1.3583719727233983e-4,662,4873481,1,Mandatory,1999,649,4813526,1.3482839814306602e-4,1,0,2,1.3583719727233983e-4,27
MN,2000,2.552933480127008e-4,16,62673,1.4290131129739551e-4,703,4919479,1,Mandatory,2000,687,4856806,1.414509865125352e-4,1,0,2,1.4290131129739551e-4,27
MN,2001,2.186372651601518e-4,14,64033,1.515213546771732e-4,755,4982796,1,Mandatory,2001,741,4918763,1.5064763234170868e-4,1,0,2,1.515213546771732e-4,27
MN,2002,3.522205206738132e-4,23,65300,1.591971205046489e-4,799,5018935,1,Mandatory,2002,776,4953635,1.5665263993007154e-4,1,0,2,1.591971205046489e-4,27
MN,2003,2.85263869078898e-4,19,66605,1.7749821314507838e-4,897,5053572,1,Mandatory,2003,878,4986967,1.7605891516827763e-4,1,0,2,1.7749821314507838e-4,27
MN,2004,4.404316229905307e-4,30,68115,1.8829678482257156e-4,958,5087713,1,Mandatory,2004,928,5019598,1.8487536252903122e-4,1,0,2,1.8829678482257156e-4,27
MN,2005,3.5705104401725273e-4,25,70018,2.1329799722556343e-4,1092,5119598,1,Mandatory,2005,1067,5049580,2.113047025693226e-4,1,0,2,2.1329799722556343e-4,27
MN,2006,5.155285561020468e-4,37,71771,2.163238311589593e-4,1117,5163555,1,Mandatory,2006,1080,5091784,2.1210640514208773e-4,1,0,2,2.163238311589593e-4,27
MN,2007,5.29028757460662e-4,39,73720,1.981870113379486e-4,1032,5207203,1,Mandatory,2007,993,5133483,1.9343591865406002e-4,1,0,2,1.981870113379486e-4,27
MN,2008,4.4885673549136613e-4,34,75748,2.1478866662931213e-4,1127,5247018,1,Mandatory,2008,1093,5171270,2.113600720906083e-4,1,0,2,2.1478866662931213e-4,27
MN,2009,5.213628424702171e-4,40,76722,2.2362329189012426e-4,1181,5281203,1,Mandatory,2009,1141,5204481,2.1923415610509482e-4,1,0,2,2.2362329189012426e-4,27
MN,2010,6.153451701813986e-4,48,78005,2.2964125623948302e-4,1218,5303925,1,Mandatory,2010,1170,5225920,2.23884024248362e-4,1,0,2,2.2964125623948302e-4,27
MN,2011,0.001468708,116,78981,9.089104468759805e-4,4858,5344861,1,Mandatory,2011,4742,5265880,9.005142540278168e-4,1,0,2,9.089104468759805e-4,27
MN,2012,0.001594176,127,79665,0.001102965,5933,5379139,1,Mandatory,2012,5806,5299474,0.00109558,1,0,2,0.001102965,27
MN,2013,0.00164093,134,81661,0.001227958,6656,5420380,1,Mandatory,2013,6522,5338719,0.001221641,1,0,2,0.001227958,27
MN,2014,0.002052768,170,82815,0.001309836,7148,5457173,1,Mandatory,2014,6978,5374358,0.001298388,1,0,2,0.001309836,27
MN,2015,0.002092199,176,84122,0.001345273,7385,5489594,1,Mandatory,2015,7209,5405472,0.001333649,1,0,2,0.001345273,27
MN,2016,0.002363288,201,85051,0.001419215,7834,5519952,1,Mandatory,2016,7633,5434901,0.001404441,1,0,2,0.001419215,27
MN,2017,0.002847229,247,86751,0.001511314,8428,5576606,1,Mandatory,2017,8181,5489855,0.001490203,1,0,2,0.001511314,27
MN,2018,0.002566928,226,88043,0.001547803,8685,5611179,1,Mandatory,2018,8459,5523136,0.001531557,1,0,2,0.001547803,27
MN,2019,0.002978264,265,88978,0.001610389,9082,5639632,1,Mandatory,2019,8817,5550654,0.001588461,1,0,2,0.001610389,27
MN,2020,0.003668798,327,89130,0.001823118,10314,5657342,1,Mandatory,2020,9987,5568212,0.001793574,1,0,2,0.001823118,27
MO,1999,0,0,27852,1.13988839881279e-4,634,5561948,0,No,1999,634,5534096,1.1456252294864419e-4,0,0,0,0,29
MO,2000,1.5685782406826452e-4,5,31876,1.447666584870526e-4,810,5595211,0,No,2000,805,5563335,1.4469738025842414e-4,0,0,0,0,29
MO,2001,0,0,32290,1.5227413172722829e-4,859,5641142,0,No,2001,859,5608852,1.5315076953358725e-4,0,0,0,0,29
MO,2002,1.5261583541908308e-4,5,32762,1.615908860625658e-4,917,5674825,0,No,2002,912,5642063,1.6164300185942624e-4,0,0,0,0,29
MO,2003,1.4966027118441138e-4,5,33409,1.8355684473490486e-4,1048,5709403,0,No,2003,1043,5675994,1.8375636055993012e-4,0,0,0,0,29
MO,2004,1.4604083301691153e-4,5,34237,1.8059268850144778e-4,1038,5747741,0,No,2004,1033,5713504,1.807997334035296e-4,0,0,0,0,29
MO,2005,1.4322953966025952e-4,5,34909,2.193323316581179e-4,1270,5790300,0,No,2005,1265,5755391,2.1979392885730962e-4,0,0,0,0,29
MO,2006,1.4023671958265552e-4,5,35654,2.3020163266870955e-4,1345,5842704,0,No,2006,1340,5807050,2.3075399729638972e-4,0,0,0,0,29
MO,2007,1.3699380787988383e-4,5,36498,2.2233122698982202e-4,1309,5887612,0,No,2007,1304,5851114,2.2286354359186985e-4,0,0,0,0,29
MO,2008,1.3348639773607068e-4,5,37457,2.3987510964031225e-4,1421,5923916,0,No,2008,1416,5886459,2.4055208742641373e-4,0,0,0,0,29
MO,2009,1.3069845253032205e-4,5,38256,2.5347721758175686e-4,1511,5961088,0,No,2009,1506,5922832,2.5427025449987437e-4,0,0,0,0,29
MO,2010,5.634668579039033e-4,22,39044,0.001455019,8714,5988927,0,No,2010,8692,5949883,0.001460869,0,0,0,0,29
MO,2011,5.014542172299669e-4,20,39884,0.001517464,9121,6010688,0,No,2011,9101,5970804,0.00152425,0,0,0,0,29
MO,2012,8.182494421026532e-4,33,40330,0.001598808,9628,6021988,0,No,2012,9595,5981658,0.00160407,0,0,0,0,29
MO,2013,7.082844861273935e-4,29,40944,0.00168162,10164,6044171,0,No,2013,10135,6003227,0.001688259,0,0,0,0,29
MO,2014,6.945608698776136e-4,29,41753,0.001700148,10309,6063589,0,No,2014,10280,6021836,0.001707121,0,0,0,0,29
MO,2015,5.869509074261028e-4,25,42593,0.001733821,10548,6083672,0,No,2015,10523,6041079,0.001741907,0,0,0,0,29
MO,2016,4.8828125e-4,21,43008,0.001840473,11214,6093000,0,No,2016,11193,6049992,0.001850085,0,0,0,0,29
MO,2017,8.192431103930092e-4,36,43943,0.001911661,11687,6113532,0,No,2017,11651,6069589,0.00191957,0,0,0,0,29
MO,2018,7.427581084426838e-4,33,44429,0.001960841,12013,6126452,0,No,2018,11980,6082023,0.001969739,0,0,0,0,29
MO,2019,7.256255772021637e-4,33,45478,0.00188825,11589,6137428,0,No,2019,11556,6091950,0.00189693,0,0,0,0,29
MO,2020,9.080492076189653e-4,42,46253,0.002053304,12631,6151548,0,No,2020,12589,6105295,0.002061981,0,0,0,0,29
MS,1999,0,0,10521,6.54078195225017e-5,185,2828408,0,No,1999,185,2817887,6.565202933971447e-5,0,0,0,0,28
MS,2000,0,0,12565,8.085330468548417e-5,230,2844658,0,No,2000,230,2832093,8.12120223453114e-5,0,0,0,0,28
MS,2001,0,0,12915,9.533844095010365e-5,272,2852994,0,No,2001,272,2840079,9.577198380749268e-5,0,0,0,0,28
MS,2002,0,0,13412,1.1858615914122633e-4,339,2858681,0,No,2002,339,2845269,1.1914514936900519e-4,0,0,0,0,28
MS,2003,3.5760263195537117e-4,5,13982,1.2132571352070486e-4,348,2868312,0,No,2003,343,2854330,1.2016830569695865e-4,0,0,0,0,28
MS,2004,3.4258307639602604e-4,5,14595,1.4226326665535944e-4,411,2889010,0,No,2004,406,2874415,1.4124613182160545e-4,0,0,0,0,28
MS,2005,3.306003702724147e-4,5,15124,1.4625200838419748e-4,425,2905943,0,No,2005,420,2890819,1.4528754653957927e-4,0,0,0,0,28
MS,2006,0,0,15686,1.9001865074365451e-4,552,2904978,0,No,2006,552,2889292,1.9105026421697773e-4,0,0,0,0,28
MS,2007,3.095400235250418e-4,5,16153,1.7518397732511483e-4,513,2928350,0,No,2007,508,2912197,1.74438748477524e-4,0,0,0,0,28
MS,2008,2.984718242597899e-4,5,16752,1.6961767497589733e-4,500,2947806,0,No,2008,495,2931054,1.688812283908792e-4,0,0,0,0,28
MS,2009,0,0,17199,1.814940918096482e-4,537,2958774,0,No,2009,537,2941575,1.8255526376176028e-4,0,0,0,0,28
MS,2010,2.828054298642534e-4,5,17680,1.8569088298205403e-4,551,2967297,0,No,2010,546,2949617,1.8510877852955147e-4,0,0,0,0,28
MS,2011,2.772694504519492e-4,5,18033,1.839844862132501e-4,548,2978512,0,No,2011,543,2960479,1.8341626473283547e-4,0,0,0,0,28
MS,2012,2.720940356987375e-4,5,18376,5.561276895976651e-4,1660,2984926,0,No,2012,1655,2966550,5.578871079199744e-4,0,0,0,0,28
MS,2013,2.732539075308777e-4,5,18298,5.519511020133344e-4,1651,2991207,0,No,2013,1646,2972909,5.536664593500844e-4,0,0,0,0,28
MS,2014,2.71370420624152e-4,5,18425,5.457437829796743e-4,1634,2994079,0,No,2014,1629,2975654,5.47442679827695e-4,0,0,0,0,28
MS,2015,2.675943270002676e-4,5,18685,5.550852796129308e-4,1661,2992333,0,No,2015,1656,2973648,5.568917370179658e-4,0,0,0,0,28
MS,2016,2.6466229091679015e-4,5,18892,5.443791100288217e-4,1627,2988726,0,No,2016,1622,2969834,5.461584721570297e-4,0,0,0,0,28
MS,2017,2.613969050606441e-4,5,19128,5.840957072484166e-4,1743,2984100,0,No,2017,1738,2964972,5.861775423174316e-4,0,0,0,0,28
MS,2018,2.5839793281653745e-4,5,19350,7.908844043086793e-4,2362,2986530,0,No,2018,2357,2967180,7.943569314972465e-4,0,0,0,0,28
MS,2019,2.5436231367960524e-4,5,19657,9.435011486320073e-4,2808,2976149,0,No,2019,2803,2956492,9.48083066012017e-4,0,0,0,0,28
MS,2020,0.001022443,20,19561,0.001002432,2974,2966786,0,No,2020,2954,2947225,0.001002299,0,0,0,0,28
MT,1999,2.2182786157941438e-4,13,58604,1.325894951237149e-4,119,897507,1,Optional,1999,106,838903,1.2635549044406804e-4,0,0,0,1.325894951237149e-4,30
MT,2000,2.3332944450925818e-4,14,60001,2.0394704027399841e-4,184,902195,1,Optional,2000,170,842194,2.0185372966323673e-4,0,0,0,2.0394704027399841e-4,30
MT,2001,3.781215578608184e-4,23,60827,2.370553970898418e-4,215,906961,1,Optional,2001,192,846134,2.2691441308350687e-4,0,0,0,2.370553970898418e-4,30
MT,2002,3.576828653649178e-4,22,61507,2.5996334187812e-4,237,911667,1,Optional,2002,215,850160,2.528935729744989e-4,0,0,0,2.5996334187812e-4,30
MT,2003,0.001187325,74,62325,0.001867055,1717,919630,1,Optional,2003,1643,857305,0.001916471,0,0,0,0.001867055,30
MT,2004,0.001408852,89,63172,0.001912885,1779,930009,1,Optional,2004,1690,866837,0.001949617,0,0,0,0.001912885,30
MT,2005,0.001382653,89,64369,0.002006165,1886,940102,1,Optional,2005,1797,875733,0.002051995,0,0,0,0.002006165,30
MT,2006,0.001519664,99,65146,0.001907227,1817,952692,1,Optional,2006,1718,887546,0.001935674,0,0,0,0.001907227,30
MT,2007,0.001342626,89,66288,0.00194567,1877,964706,1,Optional,2007,1788,898418,0.001990165,0,0,0,0.00194567,30
MT,2008,0.001339246,90,67202,0.002032947,1985,976415,1,Optional,2008,1895,909213,0.00208422,0,0,0,0.002032947,30
MT,2009,0.001346171,92,68342,0.001868937,1839,983982,1,Optional,2009,1747,915640,0.001907955,0,0,0,0.001868937,30
MT,2010,0.001399126,97,69329,0.001877877,1858,989415,1,Optional,2010,1761,920086,0.001913952,0,0,0,0.001877877,30
MT,2011,0.001826614,128,70075,0.002011623,2008,998199,1,Optional,2011,1880,928124,0.002025591,0,0,0,0.002011623,30
MT,2012,0.001599035,114,71293,0.001817655,1827,1005141,1,Optional,2012,1713,933848,0.001834346,0,0,0,0.001817655,30
MT,2013,0.00175274,127,72458,0.00191299,1942,1015165,1,Optional,2013,1815,942707,0.001925307,0,0,0,0.00191299,30
MT,2014,0.001770876,130,73410,0.001923642,1969,1023579,1,Optional,2014,1839,950169,0.001935445,0,0,0,0.001923642,30
MT,2015,0.002177917,162,74383,0.002036887,2104,1032949,1,Optional,2015,1942,958566,0.002025943,0,0,0,0.002036887,30
MT,2016,0.001824118,138,75653,0.002042167,2129,1042520,1,Optional,2016,1991,966867,0.002059228,0,0,0,0.002042167,30
MT,2017,0.002533067,194,76587,0.002159938,2269,1050493,1,Optional,2017,2075,973906,0.002130596,0,0,0,0.002159938,30
MT,2018,0.002313648,179,77367,0.002084147,2214,1062305,1,Optional,2018,2035,984938,0.00206612,0,0,0,0.002084147,30
MT,2019,0.002269434,177,77993,0.002084624,2228,1068778,1,Optional,2019,2051,990785,0.002070076,0,0,0,0.002084624,30
MT,2020,0.002726714,213,78116,0.002131269,2303,1080577,1,Optional,2020,2090,1002461,0.002084869,0,0,0,0.002131269,30
NC,1999,4.911543108613864e-5,5,101801,1.6969917456258435e-4,1349,7949361,0,No,1999,1344,7847560,1.712634245548935e-4,0,0,0,0,37
NC,2000,1.7817789656304216e-4,19,106635,2.6933975607607756e-4,2168,8049313,0,No,2000,2149,7942678,2.705636562378583e-4,0,0,0,0,37
NC,2001,2.3230048961795505e-4,26,111924,2.6077566204253726e-4,2141,8210122,0,No,2001,2115,8098198,2.6116921320027e-4,0,0,0,0,37
NC,2002,2.3175368874621253e-4,27,116503,2.8344259284636533e-4,2360,8326201,0,No,2002,2333,8209698,2.841761048944797e-4,0,0,0,0,37
NC,2003,2.2297280557597178e-4,27,121091,3.205698639869559e-4,2700,8422501,0,No,2003,2673,8301410,3.2199349267172684e-4,0,0,0,0,37
NC,2004,2.623503410554434e-4,33,125786,3.3005376263627723e-4,2823,8553152,0,No,2004,2790,8427366,3.310642969582667e-4,0,0,0,0,37
NC,2005,2.601536436813271e-4,34,130692,3.578235917057066e-4,3115,8705407,0,No,2005,3081,8574715,3.593122337010618e-4,0,0,0,0,37
NC,2006,3.159371946246593e-4,43,136103,3.589663652664997e-4,3201,8917270,0,No,2006,3158,8781167,3.5963329247695665e-4,0,0,0,0,37
NC,2007,2.400350168730497e-4,34,141646,3.6564887815217245e-4,3334,9118037,0,No,2007,3300,8976391,3.676310445924203e-4,0,0,0,0,37
NC,2008,2.9897397567439014e-4,44,147170,3.712357197509756e-4,3456,9309449,0,No,2008,3412,9162279,3.7239643106262097e-4,0,0,0,0,37
NC,2009,3.007892448228286e-4,46,152931,3.643553576957926e-4,3443,9449566,0,No,2009,3397,9296635,3.6540102951229127e-4,0,0,0,0,37
NC,2010,3.050892703917219e-4,48,157331,3.535216831701131e-4,3371,9535483,0,No,2010,3323,9378152,3.543342014503497e-4,0,0,0,0,37
NC,2011,3.268898318403269e-4,52,159075,3.5510124320644926e-4,3429,9656401,0,No,2011,3377,9497326,3.5557376886925855e-4,0,0,0,0,37
NC,2012,2.923412804548084e-4,47,160771,3.729463468946551e-4,3637,9752073,0,No,2012,3590,9591302,3.7429746243002255e-4,0,0,0,0,37
NC,2013,3.0629935248316885e-4,50,163239,3.810902858024829e-4,3753,9848060,0,No,2013,3703,9684821,3.8235089734750907e-4,0,0,0,0,37
NC,2014,9.81859836477911e-4,162,164993,0.001305415,12981,9943964,0,No,2014,12819,9778971,0.001310874,0,0,0,0,37
NC,2015,9.121021554414094e-4,152,166648,0.001328613,13343,10042802,0,No,2015,13191,9876154,0.001335641,0,0,0,0,37
NC,2016,0.001004117,170,169303,0.001396205,14167,10146788,0,No,2016,13997,9977485,0.001402859,0,0,0,0,37
NC,2017,0.001133247,195,172072,0.001464167,15042,10273419,0,No,2017,14847,10101347,0.001469804,0,0,0,0,37
NC,2018,0.001290337,225,174373,0.001507856,15657,10383620,0,No,2018,15432,10209247,0.001511571,0,0,0,0,37
NC,2019,0.001196598,212,177169,0.001515529,15895,10488084,0,No,2019,15683,10310915,0.00152101,0,0,0,0,37
NC,2020,0.001592339,287,180238,0.001607705,17043,10600823,0,No,2020,16756,10420585,0.001607971,0,0,0,0,37
ND,1999,7.935752150588833e-4,25,31503,0.001008911,650,644259,1,Optional,1999,625,612756,0.001019982,0,0,0,0.001008911,38
ND,2000,0.001281856,42,32765,0.001234818,793,642200,1,Optional,2000,751,609435,0.001232289,0,0,0,0.001234818,38
ND,2001,0.001206673,40,33149,0.001287825,823,639062,1,Optional,2001,783,605913,0.001292265,0,0,0,0.001287825,38
ND,2002,0.001602612,54,33695,0.001414988,903,638168,1,Optional,2002,849,604473,0.001404529,0,0,0,0.001414988,38
ND,2003,0.001811435,62,34227,0.001587309,1014,638817,1,Optional,2003,952,604590,0.001574621,0,0,0,0.001587309,38
ND,2004,0.001801338,63,34974,0.001485951,958,644705,1,Optional,2004,895,609731,0.00146786,0,0,0,0.001485951,38
ND,2005,0.001377256,49,35578,0.001471933,951,646089,1,Optional,2005,902,610511,0.001477451,0,0,0,0.001471933,38
ND,2006,0.0016195,59,36431,0.001541371,1001,649422,1,Optional,2006,942,612991,0.001536727,0,0,0,0.001541371,38
ND,2007,0.001321004,49,37093,0.001357185,886,652822,1,Optional,2007,837,615729,0.001359364,0,0,0,0.001357185,38
ND,2008,0.001636964,62,37875,0.001824904,1200,657569,1,Optional,2008,1138,619694,0.00183639,0,0,0,0.001824904,38
ND,2009,0.001869499,72,38513,0.001765498,1174,664968,1,Optional,2009,1102,626455,0.001759105,0,0,0,0.001765498,38
ND,2010,0.002295684,90,39204,0.001639927,1103,672591,1,Optional,2010,1013,633387,0.001599338,0,0,0,0.001639927,38
ND,2011,0.00145429,58,39882,0.001655135,1132,683932,1,Optional,2011,1074,644050,0.001667572,0,0,0,0.001655135,38
ND,2012,0.001547303,63,40716,0.001597992,1118,699628,1,Optional,2012,1055,658912,0.001601124,0,0,0,0.001597992,38
ND,2013,0.001736813,73,42031,0.001645026,1190,723393,1,Optional,2013,1117,681362,0.001639364,0,0,0,0.001645026,38
ND,2014,0.002019639,87,43077,0.001555143,1150,739482,1,Optional,2014,1063,696405,0.001526411,0,0,0,0.001555143,38
ND,2015,0.002142004,95,44351,0.001622349,1228,756927,1,Optional,2015,1133,712576,0.001590006,0,0,0,0.001622349,38
ND,2016,0.002395022,107,44676,0.001635988,1240,757952,1,Optional,2016,1133,713276,0.001588445,0,0,0,0.001635988,38
ND,2017,0.002170751,97,44685,0.001718311,1298,755393,1,Optional,2017,1201,710708,0.001689864,0,0,0,0.001718311,38
ND,2018,0.00214597,97,45201,0.00161431,1227,760077,1,Optional,2018,1130,714876,0.001580694,0,0,0,0.00161431,38
ND,2019,0.002292626,105,45799,0.001717708,1309,762062,1,Optional,2019,1204,716263,0.001680947,0,0,0,0.001717708,38
ND,2020,0.00294124,136,46239,0.001834553,1404,765309,1,Optional,2020,1268,719070,0.001763389,0,0,0,0.001834553,38
NE,1999,0,0,15408,4.223458496307993e-5,72,1704764,1,Mandatory,1999,72,1689356,4.261979121037839e-5,1,2,2,4.223458496307993e-5,31
NE,2000,2.947939390366134e-4,5,16961,7.71360100697555e-5,132,1711263,1,Mandatory,2000,127,1694302,7.495712098551498e-5,1,2,2,7.71360100697555e-5,31
NE,2001,0,0,17791,9.128777395053948e-5,157,1719836,1,Mandatory,2001,157,1702045,9.224197950112952e-5,1,2,2,9.128777395053948e-5,31
NE,2002,2.707239157507174e-4,5,18469,1.000988258928468e-4,173,1728292,1,Mandatory,2002,168,1709823,9.825578437066293e-5,1,2,2,1.000988258928468e-4,31
NE,2003,7.281805887860189e-4,14,19226,0.001269956,2208,1738643,1,Mandatory,2003,2194,1719417,0.001276014,1,2,2,0.001269956,31
NE,2004,7.968127490039841e-4,16,20080,0.001190714,2083,1749370,1,Mandatory,2004,2067,1729290,0.001195288,1,2,2,0.001190714,31
NE,2005,0.001093572,23,21032,0.001440252,2537,1761497,1,Mandatory,2005,2514,1740465,0.001444442,1,2,2,0.001440252,31
NE,2006,9.918845807033363e-4,22,22180,0.001419309,2516,1772693,1,Mandatory,2006,2494,1750513,0.001424725,1,2,2,0.001419309,31
NE,2007,9.498726307154268e-4,22,23161,0.001472435,2626,1783440,1,Mandatory,2007,2604,1760279,0.001479311,1,2,2,0.001472435,31
NE,2008,6.084945843981989e-4,15,24651,0.001493004,2682,1796378,1,Mandatory,2008,2667,1771727,0.001505311,1,2,2,0.001493004,31
NE,2009,5.555114673438616e-4,14,25202,0.001471851,2668,1812683,1,Mandatory,2009,2654,1787481,0.001484771,1,2,2,0.001471851,31
NE,2010,8.112179858616293e-4,21,25887,0.001484936,2712,1826341,1,Mandatory,2010,2691,1800454,0.001494623,1,2,2,0.001484936,31
NE,2011,0.001140121,30,26313,0.001508704,2780,1842641,1,Mandatory,2011,2750,1816328,0.001514044,1,2,2,0.001508704,31
NE,2012,7.087172218284905e-4,19,26809,0.001496611,2777,1855525,1,Mandatory,2012,2758,1828716,0.001508162,1,2,2,0.001496611,31
NE,2013,6.151174150595217e-4,17,27637,0.001479249,2764,1868516,1,Mandatory,2013,2747,1840879,0.001492222,1,2,2,0.001479249,31
NE,2014,0.001058313,30,28347,0.001499865,2822,1881503,1,Mandatory,2014,2792,1853156,0.001506619,1,2,2,0.001499865,31
NE,2015,9.589041095890411e-4,28,29200,0.00150776,2859,1896190,1,Mandatory,2015,2831,1866990,0.001516344,1,2,2,0.00150776,31
NE,2016,0.001031786,31,30045,0.001475526,2814,1907116,1,Mandatory,2016,2783,1877071,0.001482629,1,2,2,0.001475526,31
NE,2017,7.782858254694036e-4,24,30837,0.001597333,3067,1920076,1,Mandatory,2017,3043,1889239,0.001610701,1,2,2,0.001597333,31
NE,2018,6.008475112263614e-4,19,31622,0.001538407,2968,1929268,1,Mandatory,2018,2949,1897646,0.001554031,1,2,2,0.001538407,31
NE,2019,6.81346588621512e-4,22,32289,0.001472802,2849,1934408,1,Mandatory,2019,2827,1902119,0.001486237,1,2,2,0.001472802,31
NE,2020,8.557348992298386e-4,29,33889,0.001518927,2943,1937552,1,Mandatory,2020,2914,1903663,0.001530733,1,2,2,0.001518927,31
NM,1999,2.7950918187662463e-5,5,178885,2.1127360374142322e-4,382,1808082,0,No,1999,377,1629197,2.314023411533412e-4,0,0,0,0,35
NM,2000,9.170748548863906e-5,17,185372,2.5233006751890826e-4,459,1819046,0,No,2000,442,1633674,2.70555814685182e-4,0,0,0,0,35
NM,2001,2.6424547347503936e-5,5,189218,2.3912343245854922e-4,438,1831690,0,No,2001,433,1642472,2.636270207346e-4,0,0,0,0,35
NM,2002,6.74322824271472e-5,13,192786,2.5817801778571655e-4,479,1855309,0,No,2002,466,1662523,2.8029687408835847e-4,0,0,0,0,35
NM,2003,9.170058739320702e-5,18,196291,3.4459360856083435e-4,647,1877574,0,No,2003,629,1681283,3.7411905074874365e-4,0,0,0,0,35
NM,2004,1.0519250227917088e-4,21,199634,2.967736242310149e-4,565,1903808,0,No,2004,544,1704174,3.1921623026756656e-4,0,0,0,0,35
NM,2005,1.282943269235514e-4,26,202659,3.436365650006159e-4,664,1932274,0,No,2005,638,1729615,3.6886821633716173e-4,0,0,0,0,35
NM,2006,2.2885635125067562e-4,47,205369,0.001277689,2507,1962137,0,No,2006,2460,1756768,0.001400299,0,0,0,0,35
NM,2007,2.8221563187601646e-4,59,209060,0.001325582,2638,1990070,0,No,2007,2579,1781010,0.001448055,0,0,0,0,35
NM,2008,3.327147650377702e-4,71,213396,0.001386111,2787,2010662,0,No,2008,2716,1797266,0.001511184,0,0,0,0,35
NM,2009,2.617127954599717e-4,57,217796,0.001251963,2550,2036802,0,No,2009,2493,1819006,0.001370529,0,0,0,0,35
NM,2010,2.6290143462593204e-4,58,220615,0.001378705,2839,2059179,0,No,2010,2781,1838564,0.001512594,0,0,0,0,35
NM,2011,3.011425438005088e-4,67,222486,0.00135144,2814,2082224,0,No,2011,2747,1859738,0.00147709,0,0,0,0,35
NM,2012,3.95416720351521e-4,89,225079,0.001304699,2721,2085538,0,No,2012,2632,1860459,0.001414705,0,0,0,0,35
NM,2013,2.8489154398067995e-4,65,228157,0.001308213,2728,2085287,0,No,2013,2663,1857130,0.001433933,0,0,0,0,35
NM,2014,3.701671413515891e-4,85,229626,0.001362696,2842,2085572,0,No,2014,2757,1855946,0.001485496,0,0,0,0,35
NM,2015,4.5759675365321937e-4,106,231645,0.00136108,2838,2085109,0,No,2015,2732,1853464,0.001473997,0,0,0,0,35
NM,2016,4.6056369552865826e-4,107,232324,0.001353666,2817,2081015,0,No,2016,2710,1848691,0.001465902,0,0,0,0,35
NM,2017,5.298400050063623e-4,127,239695,0.001416619,2958,2088070,0,No,2017,2831,1848375,0.001531616,0,0,0,0,35
NM,2018,4.729211175872726e-4,114,241055,0.001456982,3053,2095428,0,No,2018,2939,1854373,0.001584902,0,0,0,0,35
NM,2019,5.567859838408334e-4,135,242463,0.00149893,3143,2096829,0,No,2019,3008,1854366,0.001622118,0,0,0,0,35
NM,2020,6.906049292942424e-4,170,246161,0.001728608,3641,2106319,0,No,2020,3471,1860158,0.001865971,0,0,0,0,35
NV,1999,1.6241148574027155e-4,5,30786,1.7056749355720058e-4,330,1934718,1,Optional,1999,325,1903932,1.7069937371712855e-4,0,0,0,1.7056749355720058e-4,32
NV,2000,0,0,31808,2.0567924946590955e-4,411,1998257,1,Optional,2000,411,1966449,2.0900618322671985e-4,0,0,0,2.0567924946590955e-4,32
NV,2001,1.4785900165602083e-4,5,33816,1.910980704813527e-4,401,2098399,1,Optional,2001,396,2064583,1.9180628727447625e-4,0,0,0,1.910980704813527e-4,32
NV,2002,1.4138672095916752e-4,5,35364,2.3783335196437928e-4,517,2173791,1,Optional,2002,512,2138427,2.39428327457519e-4,0,0,0,2.3783335196437928e-4,32
NV,2003,1.347963227563152e-4,5,37093,2.516841941436734e-4,566,2248850,1,Optional,2003,561,2211757,2.536445007295105e-4,0,0,0,2.516841941436734e-4,32
NV,2004,3.835924713584288e-4,15,39104,2.7022165847903563e-4,634,2346222,1,Optional,2004,619,2307118,2.683001042859533e-4,0,0,0,2.7022165847903563e-4,32
NV,2005,1.2163082611657098e-4,5,41108,2.8493390396864e-4,693,2432143,1,Optional,2005,688,2391035,2.877415010654382e-4,0,0,0,2.8493390396864e-4,32
NV,2006,2.766124198976534e-4,12,43382,2.691605441562035e-4,679,2522658,1,Optional,2006,667,2479276,2.690301523509283e-4,0,0,0,2.691605441562035e-4,32
NV,2007,1.0918222513374823e-4,5,45795,2.868048250875024e-4,746,2601072,1,Optional,2007,741,2555277,2.89988130445349e-4,0,0,0,2.868048250875024e-4,32
NV,2008,3.361556400613484e-4,16,47597,8.041814420246983e-4,2134,2653630,1,Optional,2008,2118,2606033,8.127295394954707e-4,0,0,0,8.041814420246983e-4,32
NV,2009,2.45363649375345e-4,12,48907,8.935938003438045e-4,2399,2684665,1,Optional,2009,2387,2635758,9.056218362990836e-4,0,0,0,8.935938003438045e-4,32
NV,2010,2.6124351915115954e-4,13,49762,9.068519720605166e-4,2449,2700551,1,Optional,2010,2436,2650789,9.189716722077842e-4,0,0,0,9.068519720605166e-4,32
NV,2011,4.110312970973361e-4,21,51091,9.257076467637686e-4,2521,2723322,1,Optional,2011,2500,2672231,9.355478624415329e-4,0,0,0,9.257076467637686e-4,32
NV,2012,5.611563691247896e-4,29,51679,9.02523477390337e-4,2490,2758931,1,Optional,2012,2461,2707252,9.090398677330371e-4,0,0,0,9.02523477390337e-4,32
NV,2013,3.9906504760275923e-4,21,52623,9.060490241335907e-4,2528,2790136,1,Optional,2013,2507,2737513,9.157947377784143e-4,0,0,0,9.060490241335907e-4,32
NV,2014,4.808314685702661e-4,26,54073,9.739005226658176e-4,2765,2839099,1,Optional,2014,2739,2785026,9.83473762902034e-4,0,0,0,9.739005226658176e-4,32
NV,2015,4.1515496110178517e-4,23,55401,0.001134962,3281,2890845,1,Optional,2015,3258,2835444,0.001149026,0,0,0,0.001134962,32
NV,2016,7.097861769142045e-4,40,56355,0.001421401,4179,2940058,1,Optional,2016,4139,2883703,0.001435307,0,0,0,0.001421401,32
NV,2017,4.1321602589487093e-4,24,58081,0.001300517,3899,2998039,1,Optional,2017,3875,2939958,0.001318046,0,0,0,0.001300517,32
NV,2018,6.220682930109787e-4,37,59479,0.001314596,3989,3034392,1,Optional,2018,3952,2974913,0.001328442,0,0,0,0.001314596,32
NV,2019,8.213822220031869e-4,50,60873,0.001404799,4327,3080156,1,Optional,2019,4277,3019283,0.001416561,0,0,0,0.001404799,32
NV,2020,7.371676735949744e-4,46,62401,0.001459727,4581,3138259,1,Optional,2020,4535,3075858,0.001474385,0,0,0,0.001459727,32
NY,1999,4.3966866569353336e-5,5,113722,1.0840596365196231e-4,2047,18882725,0,No,1999,2042,18769003,1.0879640223830749e-4,0,1,1,0,36
NY,2000,4.1543766357858004e-5,5,120355,1.2004348335413718e-4,2278,18976457,0,No,2000,2273,18856102,1.2054453248078527e-4,0,1,1,0,36
NY,2001,9.202736280253996e-5,12,130396,1.4840559878986554e-4,2832,19082838,0,No,2001,2820,18952442,1.4879349056971127e-4,0,1,1,0,36
NY,2002,3.590870570661151e-5,5,139242,1.410297944382322e-4,2699,19137800,0,No,2002,2694,18998558,1.418002355757737e-4,0,1,1,0,36
NY,2003,2.3658079910234486e-4,35,147941,7.574596477387626e-4,14525,19175939,0,No,2003,14490,19027998,7.615094346762071e-4,0,1,1,0,36
NY,2004,2.3615463660907473e-4,37,156677,8.257540972002967e-4,15831,19171567,0,No,2004,15794,19014890,8.30612220212686e-4,0,1,1,0,36
NY,2005,1.5107565868987188e-4,25,165480,8.570184621962189e-4,16397,19132610,0,No,2005,16372,18967130,8.631775076144889e-4,0,1,1,0,36
NY,2006,2.8068165544894747e-4,49,174575,8.877952157254437e-4,16961,19104631,0,No,2006,16912,18930056,8.933940818769897e-4,0,1,1,0,36
NY,2007,2.1723782110465433e-4,40,184130,9.09559653853019e-4,17402,19132335,0,No,2007,17362,18948205,9.162873211473066e-4,0,1,1,0,36
NY,2008,2.512820512820513e-4,49,195000,9.196647421493038e-4,17669,19212436,0,No,2008,17620,19017436,9.26518169957296e-4,0,1,1,0,36
NY,2009,1.7912731110540916e-4,37,206557,9.064556986545755e-4,17501,19307066,0,No,2009,17464,19100509,9.14321183796725e-4,0,1,1,0,36
NY,2010,2.7023375219564923e-4,58,214629,9.122668463609078e-4,17678,19378102,0,No,2010,17620,19163473,9.194575534403394e-4,0,1,1,0,36
NY,2011,2.491108127932242e-4,54,216771,9.421430463817037e-4,18339,19465197,0,No,2011,18285,19248426,9.499478035242986e-4,0,1,1,0,36
NY,2012,1.9666492869752935e-4,43,218646,9.50319466868633e-4,18598,19570261,0,No,2012,18555,19351615,9.588347019098923e-4,0,1,1,0,36
NY,2013,2.40273458396424e-4,53,220582,9.664076772797815e-4,18991,19651127,0,No,2013,18938,19430545,9.746509940920339e-4,0,1,1,0,36
NY,2014,2.4649749468909945e-4,55,223126,9.6580475854957e-4,19071,19746227,0,No,2014,19016,19523101,9.740255915287228e-4,0,1,1,0,36
NY,2015,2.8082249789383127e-4,63,224341,0.001003648,19868,19795791,0,No,2015,19805,19571450,0.001011933,0,1,1,0,36
NY,2016,3.32359888149819e-4,75,225659,0.00104587,20651,19745289,0,No,2016,20576,19519630,0.001054118,0,1,1,0,36
NY,2017,3.2466250455185605e-4,74,227929,0.001041039,20664,19849399,0,No,2017,20590,19621470,0.001049361,0,1,1,0,36
NY,2018,2.894781377203374e-4,65,224542,0.00108345,21173,19542209,0,No,2018,21108,19317667,0.001092679,0,1,1,0,36
NY,2019,3.484398382881776e-4,78,223855,0.001097074,21342,19453561,0,No,2019,21264,19229706,0.001105789,0,1,1,0,36
NY,2020,3.647432251117026e-4,84,230299,0.001187064,22954,19336776,0,No,2020,22870,19106477,0.001196976,0,1,1,0,36
OK,1999,8.11930836483625e-5,25,307908,9.455516450125643e-5,325,3437147,0,No,1999,300,3129239,9.586995432435809e-5,0,0,0,0,40
OK,2000,5.7613827318556455e-5,18,312425,1.437408676732005e-4,496,3450654,0,No,2000,478,3138229,1.5231520708017165e-4,0,0,0,0,40
OK,2001,8.779686314350397e-5,28,318918,1.577687404459058e-4,547,3467100,0,No,2001,519,3148182,1.6485705083124164e-4,0,0,0,0,40
OK,2002,8.613211435883869e-5,28,325082,1.5247572425969023e-4,532,3489080,0,No,2002,504,3163998,1.592921360885816e-4,0,0,0,0,40
OK,2003,1.2067748339176135e-4,40,331462,2.3281744487419298e-4,816,3504892,0,No,2003,776,3173430,2.4453036619682803e-4,0,0,0,0,40
OK,2004,8.411749199550979e-4,284,337623,0.00138232,4873,3525233,0,No,2004,4589,3187610,0.001439637,0,0,0,0,40
OK,2005,9.860617274641392e-4,340,344806,0.001602605,5687,3548597,0,No,2005,5347,3203791,0.00166896,0,0,0,0,40
OK,2006,0.001083335,383,353538,0.001560618,5609,3594090,0,No,2006,5226,3240552,0.001612688,0,0,0,0,40
OK,2007,0.001144228,414,361816,0.001677604,6097,3634349,0,No,2007,5683,3272533,0.001736575,0,0,0,0,40
OK,2008,0.001049581,389,370624,0.001483793,5444,3668976,0,No,2008,5055,3298352,0.001532584,0,0,0,0,40
OK,2009,0.001020875,388,380066,0.001423241,5291,3717572,0,No,2009,4903,3337506,0.001469061,0,0,0,0,40
OK,2010,0.001146614,444,387227,0.001453077,5451,3751351,0,No,2010,5007,3364124,0.001488352,0,0,0,0,40
OK,2011,0.001075938,420,390357,0.00156745,5943,3791508,0,No,2011,5523,3401151,0.001623862,0,0,0,0,40
OK,2012,0.001082777,428,395280,0.001453542,5545,3814820,0,No,2012,5117,3419540,0.0014964,0,0,0,0,40
OK,2013,0.001026845,411,400255,0.001293835,4982,3850568,0,No,2013,4571,3450313,0.001324807,0,0,0,0,40
OK,2014,0.001120249,454,405267,0.001263521,4900,3878051,0,No,2014,4446,3472784,0.001280241,0,0,0,0,40
OK,2015,0.001098058,451,410725,0.001267341,4957,3911338,0,No,2015,4506,3500613,0.001287203,0,0,0,0,40
OK,2016,0.001142464,475,415768,0.001275882,5006,3923561,0,No,2016,4531,3507793,0.001291695,0,0,0,0,40
OK,2017,0.001101293,462,419507,0.001258502,4947,3930864,0,No,2017,4485,3511357,0.001277284,0,0,0,0,40
OK,2018,0.001173645,497,423467,0.001220366,4812,3943079,0,No,2018,4315,3519612,0.001225987,0,0,0,0,40
OK,2019,0.001094179,468,427718,0.00115644,4576,3956971,0,No,2019,4108,3529253,0.001163986,0,0,0,0,40
OK,2020,0.001209248,532,439943,0.001184189,4714,3980783,0,No,2020,4182,3540840,0.001181076,0,0,0,0,40
OR,1999,2.3491994651053525e-4,13,55338,1.564552831059821e-4,531,3393941,1,Mandatory,1999,518,3338603,1.551547159096185e-4,1,0,2,1.564552831059821e-4,41
OR,2000,1.752817654379415e-4,10,57051,1.7507458206423746e-4,599,3421399,1,Mandatory,2000,589,3364348,1.7507106874794164e-4,1,0,2,1.7507458206423746e-4,41
OR,2001,2.03231378924906e-4,12,59046,1.88873096598929e-4,655,3467937,1,Mandatory,2001,643,3408891,1.886243942678132e-4,1,0,2,1.88873096598929e-4,41
OR,2002,2.624499704743783e-4,16,60964,2.2855197664728197e-4,803,3513424,1,Mandatory,2002,787,3452460,2.2795340134281063e-4,1,0,2,2.2855197664728197e-4,41
OR,2003,0.001063543,67,62997,0.002012192,7138,3547376,1,Mandatory,2003,7071,3484379,0.002029343,1,0,2,0.002012192,41
OR,2004,0.001245005,81,65060,0.001954356,6976,3569463,1,Mandatory,2004,6895,3504403,0.001967525,1,0,2,0.001954356,41
OR,2005,0.001109287,75,67611,0.002015387,7282,3613202,1,Mandatory,2005,7207,3545591,0.002032665,1,0,2,0.002015387,41
OR,2006,0.001155261,81,70114,0.001994888,7323,3670883,1,Mandatory,2006,7242,3600769,0.002011237,1,0,2,0.001994888,41
OR,2007,0.001078793,79,73230,0.001967807,7325,3722417,1,Mandatory,2007,7246,3649187,0.001985648,1,0,2,0.001967807,41
OR,2008,0.001151848,88,76399,0.002025341,7633,3768748,1,Mandatory,2008,7545,3692349,0.002043415,1,0,2,0.002025341,41
OR,2009,0.001131606,90,79533,0.001950586,7429,3808600,1,Mandatory,2009,7339,3729067,0.001968053,1,0,2,0.001950586,41
OR,2010,0.001173795,96,81786,0.001944624,7450,3831074,1,Mandatory,2010,7354,3749288,0.001961439,1,0,2,0.001944624,41
OR,2011,0.001003344,84,83720,0.002000848,7747,3871859,1,Mandatory,2011,7663,3788139,0.002022893,1,0,2,0.002000848,41
OR,2012,9.127548601232812e-4,77,84360,0.00193109,7530,3899353,1,Mandatory,2012,7453,3814993,0.001953608,1,0,2,0.00193109,41
OR,2013,0.001054321,90,85363,0.001990298,7822,3930065,1,Mandatory,2013,7732,3844702,0.002011079,1,0,2,0.001990298,41
OR,2014,0.001292646,112,86644,0.0019354,7684,3970239,1,Mandatory,2014,7572,3883595,0.00194974,1,0,2,0.0019354,41
OR,2015,0.001153546,102,88423,0.002002493,8068,4028977,1,Mandatory,2015,7966,3940554,0.002021543,1,0,2,0.002002493,41
OR,2016,0.001223908,110,89876,0.001991467,8152,4093465,1,Mandatory,2016,8042,4003589,0.002008698,1,0,2,0.001991467,41
OR,2017,0.001462052,134,91652,0.001997694,8276,4142776,1,Mandatory,2017,8142,4051124,0.002009813,1,0,2,0.001997694,41
OR,2018,0.001199143,112,93400,0.001941674,8137,4190713,1,Mandatory,2018,8025,4097313,0.001958601,1,0,2,0.001941674,41
OR,2019,0.001247133,118,94617,0.002012928,8490,4217737,1,Mandatory,2019,8372,4123120,0.002030501,1,0,2,0.002012928,41
OR,2020,0.001656709,160,96577,0.002099254,8904,4241507,1,Mandatory,2020,8744,4144930,0.002109565,1,0,2,0.002099254,41
RI,1999,0,0,6235,1.4417504003260277e-4,150,1040402,0,No,1999,150,1034167,1.450442723467293e-4,0,1,1,0,44
RI,2000,7.44047619047619e-4,5,6720,2.1462932561558076e-4,225,1048319,0,No,2000,220,1041599,2.1121372044327998e-4,0,1,1,0,44
RI,2001,7.03037120359955e-4,5,7112,2.374326249453716e-4,251,1057142,0,No,2001,246,1050030,2.3427902059941144e-4,0,1,1,0,44
RI,2002,6.63129973474801e-4,5,7540,2.1669895262172898e-4,231,1065995,0,No,2002,226,1058455,2.1351876083536853e-4,0,1,1,0,44
RI,2003,6.257039169065198e-4,5,7991,2.557539982563924e-4,274,1071342,0,No,2003,269,1063351,2.529738534124668e-4,0,1,1,0,44
RI,2004,0,0,8325,2.1031492333276568e-4,226,1074579,0,No,2004,226,1066254,2.1195700086470954e-4,0,1,1,0,44
RI,2005,5.708414202534536e-4,5,8759,2.856029875008896e-4,305,1067916,0,No,2005,300,1059157,2.8324412716905994e-4,0,1,1,0,44
RI,2006,5.470459518599562e-4,5,9140,0.001471175,1564,1063096,0,No,2006,1559,1053956,0.001479189,0,1,1,0,44
RI,2007,5.361930294906167e-4,5,9325,0.001423417,1505,1057315,0,No,2007,1500,1047990,0.001431311,0,1,1,0,44
RI,2008,5.150922015040693e-4,5,9707,0.00144265,1522,1055003,0,No,2008,1517,1045296,0.001451264,0,1,1,0,44
RI,2009,9.811616954474097e-4,10,10192,0.00143217,1509,1053646,0,No,2009,1499,1043454,0.001436575,0,1,1,0,44
RI,2010,4.762811964183654e-4,5,10498,0.001512493,1592,1052567,0,No,2010,1587,1042069,0.001522932,0,1,1,0,44
RI,2011,4.743382980741865e-4,5,10541,0.001580897,1662,1051302,0,No,2011,1657,1040761,0.001592104,0,1,1,0,44
RI,2012,4.6742077217911565e-4,5,10697,0.001636688,1719,1050292,0,No,2012,1714,1039595,0.001648719,0,1,1,0,44
RI,2013,4.5591319412783806e-4,5,10967,0.001683292,1770,1051511,0,No,2013,1765,1040544,0.001696228,0,1,1,0,44
RI,2014,4.422039444591846e-4,5,11307,0.00164428,1735,1055173,0,No,2014,1730,1043866,0.001657301,0,1,1,0,44
RI,2015,8.651267410675664e-4,10,11559,0.001723945,1821,1056298,0,No,2015,1811,1044739,0.001733447,0,1,1,0,44
RI,2016,4.17641162712997e-4,5,11972,0.001583641,1673,1056426,0,No,2016,1668,1044454,0.001597007,0,1,1,0,44
RI,2017,9.710309111506716e-4,12,12358,0.001681705,1782,1059639,0,No,2017,1770,1047281,0.001690091,0,1,1,0,44
RI,2018,3.939799858167205e-4,5,12691,0.001612575,1705,1057315,0,No,2018,1700,1044624,0.00162738,0,1,1,0,44
RI,2019,3.8874203078836884e-4,5,12862,0.001653827,1752,1059361,0,No,2019,1747,1046499,0.001669376,0,1,1,0,44
RI,2020,8.94254415381176e-4,12,13419,0.001768003,1869,1057125,0,No,2020,1857,1043706,0.001779237,0,1,1,0,44
SC,1999,0,0,13624,9.736627986842721e-5,387,3974682,0,No,1999,387,3961058,9.770116973798414e-5,0,0,0,0,45
SC,2000,3.1891822936599057e-4,5,15678,1.8319985084790374e-4,735,4012012,0,No,2000,730,3996334,1.8266741468555932e-4,0,0,0,0,45
SC,2001,3.028284174186906e-4,5,16511,1.6359183713633105e-4,665,4064995,0,No,2001,660,4048484,1.630239862625121e-4,0,0,0,0,45
SC,2002,2.8412319581770656e-4,5,17598,1.453334453155525e-4,597,4107795,0,No,2002,592,4090197,1.4473630487724673e-4,0,0,0,0,45
SC,2003,0,0,18512,1.701083079114579e-4,706,4150297,0,No,2003,706,4131785,1.7087045913570043e-4,0,0,0,0,45
SC,2004,0,0,19636,1.8380777031912972e-4,774,4210921,0,No,2004,774,4191285,1.8466890225789942e-4,0,0,0,0,45
SC,2005,4.8334863937358016e-4,10,20689,0.001442572,6160,4270150,0,No,2005,6150,4249461,0.001447242,0,0,0,0,45
SC,2006,6.353528477422282e-4,14,22035,0.001457142,6350,4357847,0,No,2006,6336,4335812,0.001461318,0,0,0,0,45
SC,2007,2.1310147892426374e-4,5,23463,0.001396905,6208,4444110,0,No,2007,6203,4420647,0.001403188,0,0,0,0,45
SC,2008,3.992334717342702e-4,10,25048,0.001314861,5955,4528996,0,No,2008,5945,4503948,0.001319953,0,0,0,0,45
SC,2009,1.9245573518090838e-4,5,25980,0.001324656,6080,4589872,0,No,2009,6075,4563892,0.001331101,0,0,0,0,45
SC,2010,3.728977887161129e-4,10,26817,0.001367244,6324,4625364,0,No,2010,6314,4598547,0.001373042,0,0,0,0,45
SC,2011,8.091805208180079e-4,22,27188,0.001291879,6045,4679230,0,No,2011,6023,4652042,0.0012947,0,0,0,0,45
SC,2012,3.6325329652366593e-4,10,27529,0.001305326,6166,4723723,0,No,2012,6156,4696194,0.001310849,0,0,0,0,45
SC,2013,4.2835724994645533e-4,12,28014,0.00130706,6241,4774839,0,No,2013,6229,4746825,0.001312246,0,0,0,0,45
SC,2014,3.5277101633329804e-4,10,28347,0.001340512,6478,4832482,0,No,2014,6468,4804135,0.00134634,0,0,0,0,45
SC,2015,4.8417776240705515e-4,14,28915,0.001379248,6753,4896146,0,No,2015,6739,4867231,0.001384565,0,0,0,0,45
SC,2016,3.3870749220972767e-4,10,29524,0.001369651,6795,4961119,0,No,2016,6785,4931595,0.001375823,0,0,0,0,45
SC,2017,4.3344891971192317e-4,13,29992,0.001396195,7015,5024369,0,No,2017,7002,4994377,0.001401977,0,0,0,0,45
SC,2018,4.601781546855997e-4,14,30423,0.001347724,6852,5084127,0,No,2018,6838,5053704,0.001353067,0,0,0,0,45
SC,2019,4.8304511641387304e-4,15,31053,0.001250409,6438,5148714,0,No,2019,6423,5117661,0.001255066,0,0,0,0,45
SC,2020,8.754377188594297e-4,28,31984,0.001482166,7734,5218040,0,No,2020,7706,5186056,0.001485908,0,0,0,0,45
SD,1999,7.915149596327371e-5,5,63170,7.329307100632719e-5,55,750412,1,Optional,1999,50,687242,7.275457553525541e-5,0,0,0,7.329307100632719e-5,46
SD,2000,2.1496790836225165e-4,14,65126,1.3910158920253722e-4,105,754844,1,Optional,2000,91,689718,1.3193798044998102e-4,0,0,0,1.3910158920253722e-4,46
SD,2001,1.811867733655443e-4,12,66230,1.2137651522747543e-4,92,757972,1,Optional,2001,80,691742,1.1565005450008818e-4,0,0,0,1.2137651522747543e-4,46
SD,2002,7.447901926027438e-5,5,67133,1.1973369121865214e-4,91,760020,1,Optional,2002,86,692887,1.2411836273447185e-4,0,0,0,1.1973369121865214e-4,46
SD,2003,1.4646649578908824e-4,10,68275,1.3617395699259816e-4,104,763729,1,Optional,2003,94,695454,1.3516350470340238e-4,0,0,0,1.3617395699259816e-4,46
SD,2004,0.001380004,96,69565,0.001378512,1062,770396,1,Optional,2004,966,700831,0.001378364,0,0,0,0.001378512,46
SD,2005,0.001288897,91,70603,0.001694406,1314,775493,1,Optional,2005,1223,704890,0.001735022,0,0,0,0.001694406,46
SD,2006,9.313057740957994e-4,67,71942,0.001480142,1159,783033,1,Optional,2006,1092,711091,0.001535668,0,0,0,0.001480142,46
SD,2007,0.001022383,75,73358,0.001533558,1214,791623,1,Optional,2007,1139,718265,0.001585766,0,0,0,0.001533558,46
SD,2008,0.001270223,95,74790,0.001620524,1295,799124,1,Optional,2008,1200,724334,0.001656694,0,0,0,0.001620524,46
SD,2009,0.001183665,90,76035,0.001528993,1234,807067,1,Optional,2009,1144,731032,0.001564911,0,0,0,0.001528993,46
SD,2010,0.001295454,100,77193,0.001492299,1215,814180,1,Optional,2010,1115,736987,0.001512917,0,0,0,0.001492299,46
SD,2011,0.001312116,102,77737,0.001575086,1298,824082,1,Optional,2011,1196,746345,0.001602476,0,0,0,0.001575086,46
SD,2012,0.001307422,103,78781,0.001502363,1252,833354,1,Optional,2012,1149,754573,0.001522715,0,0,0,0.001502363,46
SD,2013,0.0014017,112,79903,0.00150081,1268,844877,1,Optional,2013,1156,764974,0.001511162,0,0,0,0.00150081,46
SD,2014,0.00109104,88,80657,0.001557711,1329,853175,1,Optional,2014,1241,772518,0.001606435,0,0,0,0.001557711,46
SD,2015,0.001606376,131,81550,0.001564413,1343,858469,1,Optional,2015,1212,776919,0.001560008,0,0,0,0.001564413,46
SD,2016,0.001618944,134,82770,0.001572585,1361,865454,1,Optional,2016,1227,782684,0.001567682,0,0,0,0.001572585,46
SD,2017,0.001614794,135,83602,0.001583366,1377,869666,1,Optional,2017,1242,786064,0.001580024,0,0,0,0.001583366,46
SD,2018,0.001535572,130,84659,0.001708162,1507,882235,1,Optional,2018,1377,797576,0.001726481,0,0,0,0.001708162,46
SD,2019,0.001606058,137,85302,0.001857213,1643,884659,1,Optional,2019,1506,799357,0.001884014,0,0,0,0.001857213,46
SD,2020,0.001931609,165,85421,0.001843809,1646,892717,1,Optional,2020,1481,807296,0.001834519,0,0,0,0.001843809,46
TN,1999,0,0,14433,1.0977695946552277e-4,619,5638706,0,No,1999,619,5624273,1.1005866891596478e-4,0,0,0,0,47
TN,2000,2.876208007363092e-4,5,17384,1.5362216996412376e-4,874,5689283,0,No,2000,869,5671899,1.53211472912335e-4,0,0,0,0,47
TN,2001,0,0,18369,1.7058528838390699e-4,981,5750789,0,No,2001,981,5732420,1.711319128744928e-4,0,0,0,0,47
TN,2002,2.594168309639929e-4,5,19274,1.903063500898391e-4,1103,5795918,0,No,2002,1098,5776644,1.9007576025110773e-4,0,0,0,0,47
TN,2003,0,0,20160,2.1649122783016963e-4,1266,5847812,0,No,2003,1266,5827652,2.172401509218464e-4,0,0,0,0,47
TN,2004,2.3496240601503758e-4,5,21280,2.442982001279351e-4,1444,5910809,0,No,2004,1439,5889529,2.443319321460171e-4,0,0,0,0,47
TN,2005,2.2418508720799892e-4,5,22303,2.7657890752833767e-4,1657,5991057,0,No,2005,1652,5968754,2.7677468362743713e-4,0,0,0,0,47
TN,2006,2.1353833013025838e-4,5,23415,2.815020317745829e-4,1714,6088766,0,No,2006,1709,6065351,2.817644024228771e-4,0,0,0,0,47
TN,2007,1.9683489489016613e-4,5,25402,2.6701309821499557e-4,1649,6175727,0,No,2007,1644,6150325,2.6730294740521843e-4,0,0,0,0,47
TN,2008,1.8755392175250386e-4,5,26659,2.5866715028033215e-4,1616,6247411,0,No,2008,1611,6220752,2.589719056474201e-4,0,0,0,0,47
TN,2009,1.7952032170041648e-4,5,27852,2.9384624435796974e-4,1853,6306019,0,No,2009,1848,6278167,2.94353431503176e-4,0,0,0,0,47
TN,2010,1.760749374933972e-4,5,28397,3.157842487636117e-4,2004,6346105,0,No,2010,1999,6317708,3.1641221784862485e-4,0,0,0,0,47
TN,2011,1.7276528108911234e-4,5,28941,3.0718281500332717e-4,1967,6403353,0,No,2011,1962,6374412,3.077930952690225e-4,0,0,0,0,47
TN,2012,4.0759485071838593e-4,12,29441,0.00126854,8190,6456243,0,No,2012,8178,6426802,0.001272484,0,0,0,0,47
TN,2013,3.3252419113490505e-4,10,30073,0.001340214,8706,6495978,0,No,2013,8696,6465905,0.001344901,0,0,0,0,47
TN,2014,1.607665348381081e-4,5,31101,9.249770053586981e-4,6058,6549352,0,No,2014,6053,6518251,9.286233377634583e-4,0,0,0,0,47
TN,2015,1.5709438230488877e-4,5,31828,0.001462813,9655,6600299,0,No,2015,9650,6568471,0.001469139,0,0,0,0,47
TN,2016,4.6383623488666933e-4,15,32339,0.001605125,10676,6651194,0,No,2016,10661,6618855,0.001610702,0,0,0,0,47
TN,2017,4.793002216763525e-4,16,33382,0.001864656,12523,6715984,0,No,2017,12507,6682602,0.001871576,0,0,0,0,47
TN,2018,5.531939672742095e-4,19,34346,0.002125698,14391,6770010,0,No,2018,14372,6735664,0.002133717,0,0,0,0,47
TN,2019,7.082955575702629e-4,25,35296,0.002223402,15184,6829174,0,No,2019,15159,6793878,0.002231274,0,0,0,0,47
TN,2020,5.470609152329112e-4,20,36559,0.002373369,16345,6886834,0,No,2020,16325,6850275,0.002383116,0,0,0,0,47
TX,1999,3.693771562391495e-5,5,135363,1.514722578122036e-4,3114,20558220,0,No,1999,3109,20422857,1.522313944616074e-4,0,0,1,0,48
TX,2000,3.287073255714577e-5,5,152111,1.7034484280029272e-4,3552,20851820,0,No,2000,3547,20699709,1.7135506590938067e-4,0,0,1,0,48
TX,2001,3.101082898148033e-5,5,161234,1.8058481524672437e-4,3850,21319622,0,No,2001,3845,21158388,1.8172461909669112e-4,0,0,1,0,48
TX,2002,2.9487391191526503e-5,5,169564,1.8787178154315345e-4,4075,21690325,0,No,2002,4070,21520761,1.8911970631521814e-4,0,0,1,0,48
TX,2003,1.737989650551952e-4,31,178367,0.001067091,23509,22030931,0,No,2003,23478,21852564,0.001074382,0,0,1,0,48
TX,2004,1.592356687898089e-4,30,188400,0.001029426,23053,22394023,0,No,2004,23023,22205623,0.001036809,0,0,1,0,48
TX,2005,1.253786435033802e-4,25,199396,0.001025458,23358,22778123,0,No,2005,23333,22578727,0.001033406,0,0,1,0,48
TX,2006,2.019585280511002e-4,43,212915,9.553682043940858e-4,22317,23359580,0,No,2006,22274,23146665,9.622984563866976e-4,0,0,1,0,48
TX,2007,1.6270101270387095e-4,37,227411,9.402910366292221e-4,22409,23831983,0,No,2007,22372,23604572,9.477824889178249e-4,0,0,1,0,48
TX,2008,1.1070836955273818e-4,27,243884,9.194933621193335e-4,22352,24309039,0,No,2008,22325,24065155,9.276898486629319e-4,0,0,1,0,48
TX,2009,1.4893909536684846e-4,39,261852,9.213055476181712e-4,22850,24801761,0,No,2009,22811,24539909,9.295470492575992e-4,0,0,1,0,48
TX,2010,1.1595001105148542e-4,32,275981,9.165832490275321e-4,23048,25145561,0,No,2010,23016,24869580,9.254679813651859e-4,0,0,1,0,48
TX,2011,1.348016342105809e-4,39,289314,9.281127971950265e-4,23829,25674681,0,No,2011,23790,25385367,9.371540699017666e-4,0,0,1,0,48
TX,2012,1.2668456228771775e-4,37,292064,9.441194345045779e-4,24603,26059203,0,No,2012,24566,25767139,9.53384851923219e-4,0,0,1,0,48
TX,2013,1.4832593950998504e-4,44,296644,9.446770144183385e-4,24985,26448193,0,No,2013,24941,26151549,9.537102372023929e-4,0,0,1,0,48
TX,2014,1.8496682157637974e-4,56,302757,9.435411814641696e-4,25435,26956958,0,No,2014,25379,26654201,9.521575979711416e-4,0,0,1,0,48
TX,2015,1.7756713652007154e-4,55,309742,9.564560400455581e-4,26273,27469114,0,No,2015,26218,27159372,9.653389629185829e-4,0,0,1,0,48
TX,2016,1.9138328649759016e-4,60,313507,9.466095693308693e-4,26375,27862596,0,No,2016,26315,27549089,9.552039996676478e-4,0,0,1,0,48
TX,2017,1.78993678696926e-4,57,318447,9.574416819091853e-4,27100,28304596,0,No,2017,27043,27986149,9.662994361960983e-4,0,0,1,0,48
TX,2018,1.9818782011977976e-4,64,322926,9.552347592985748e-4,27417,28701845,0,No,2018,27353,28378919,9.638492572602924e-4,0,0,1,0,48
TX,2019,1.984290524554832e-4,65,327573,0.001016213,29466,28995881,0,No,2019,29401,28668308,0.001025558,0,0,1,0,48
TX,2020,1.941153633486665e-4,66,340004,0.00108049,31724,29360759,0,No,2020,31658,29020755,0.001090874,0,0,1,0,48
UT,1999,1.5295665208479918e-4,5,32689,1.1754123700579356e-4,259,2203482,1,Optional,1999,254,2170793,1.170079321243435e-4,0,0,0,1.1754123700579356e-4,49
UT,2000,1.4822280852577594e-4,5,33733,1.325470665229546e-4,296,2233169,1,Optional,2000,291,2199436,1.3230664588558157e-4,0,0,0,1.325470665229546e-4,49
UT,2001,1.4523062623446033e-4,5,34428,1.322406692603937e-4,302,2283715,1,Optional,2001,297,2249287,1.3204184259278608e-4,0,0,0,1.322406692603937e-4,49
UT,2002,1.4150676402332031e-4,5,35334,1.608730157023247e-4,374,2324815,1,Optional,2002,369,2289481,1.6117189878404756e-4,0,0,0,1.608730157023247e-4,49
UT,2003,3.0587842722874147e-4,11,35962,2.779499664638112e-4,656,2360137,1,Optional,2003,645,2324175,2.775178289070315e-4,0,0,0,2.779499664638112e-4,49
UT,2004,3.2654838358550127e-4,12,36748,7.557524629618834e-4,1815,2401580,1,Optional,2004,1803,2364832,7.624220240592144e-4,0,0,0,7.557524629618834e-4,49
UT,2005,5.003423394954442e-4,19,37974,7.885360368699595e-4,1938,2457719,1,Optional,2005,1919,2419745,7.93058772721919e-4,0,0,0,7.885360368699595e-4,49
UT,2006,1.2679413703910332e-4,5,39434,7.8281311435684e-4,1977,2525507,1,Optional,2006,1972,2486073,7.932188636455969e-4,0,0,0,7.8281311435684e-4,49
UT,2007,5.319148936170213e-4,22,41360,8.087780714511734e-4,2101,2597746,1,Optional,2007,2079,2556386,8.132574658130658e-4,0,0,0,8.087780714511734e-4,49
UT,2008,2.7892057736559516e-4,12,43023,7.743062505139824e-4,2062,2663029,1,Optional,2008,2050,2620006,7.824409562420849e-4,0,0,0,7.743062505139824e-4,49
UT,2009,5.155101308947463e-4,23,44616,7.89081085884261e-4,2149,2723421,1,Optional,2009,2126,2678805,7.936374614800256e-4,0,0,0,7.89081085884261e-4,49
UT,2010,4.7790763348829125e-4,22,46034,7.42071395879351e-4,2051,2763885,1,Optional,2010,2029,2717851,7.465457083556089e-4,0,0,0,7.42071395879351e-4,49
UT,2011,5.245929158972637e-4,25,47656,7.482548411165325e-4,2108,2817222,1,Optional,2011,2083,2769566,7.521033981497462e-4,0,0,0,7.482548411165325e-4,49
UT,2012,4.6080053620426033e-4,22,47743,7.946661754142403e-4,2269,2855287,1,Optional,2012,2247,2807544,8.003436455492772e-4,0,0,0,7.946661754142403e-4,49
UT,2013,4.2934249263984297e-4,21,48912,7.856258394027726e-4,2279,2900872,1,Optional,2013,2258,2851960,7.91736209484004e-4,0,0,0,7.856258394027726e-4,49
UT,2014,6.139829669241434e-4,31,50490,8.151817491713961e-4,2399,2942902,1,Optional,2014,2368,2892412,8.186938790186184e-4,0,0,0,8.151817491713961e-4,49
UT,2015,3.647673168484104e-4,19,52088,8.4014287435675e-4,2517,2995919,1,Optional,2015,2498,2943831,8.485541459411223e-4,0,0,0,8.4014287435675e-4,49
UT,2016,5.584512285927029e-4,30,53720,8.521190069405093e-4,2600,3051217,1,Optional,2016,2570,2997497,8.573820090562225e-4,0,0,0,8.521190069405093e-4,49
UT,2017,5.374550576374217e-4,29,53958,8.504648702879878e-4,2638,3101833,1,Optional,2017,2609,3047875,8.560062338514539e-4,0,0,0,8.504648702879878e-4,49
UT,2018,7.604562737642585e-4,42,55230,8.48121147510127e-4,2681,3161105,1,Optional,2018,2639,3105875,8.496800418561597e-4,0,0,0,8.48121147510127e-4,49
UT,2019,6.90742282283346e-4,39,56461,8.462369126482631e-4,2713,3205958,1,Optional,2019,2674,3149497,8.490244632714367e-4,0,0,0,8.462369126482631e-4,49
UT,2020,7.30523715930635e-4,42,57493,9.698822633088802e-4,3152,3249879,1,Optional,2020,3110,3192386,9.74192970398943e-4,0,0,0,9.698822633088802e-4,49
WA,1999,2.45378701128742e-4,27,110034,1.6345563351980399e-4,955,5842564,1,Optional,1999,928,5732530,1.6188314758056217e-4,0,1,1,1.6345563351980399e-4,53
WA,2000,1.6963376961948466e-4,19,112006,2.4719546816225866e-4,1457,5894121,1,Optional,2000,1438,5782115,2.486979245483703e-4,0,1,1,2.4719546816225866e-4,53
WA,2001,2.779683984676992e-4,32,115121,2.3472523448299135e-4,1405,5985722,1,Optional,2001,1373,5870601,2.338772469803347e-4,0,1,1,2.3472523448299135e-4,53
WA,2002,3.1438792070626824e-4,37,117689,2.608904410502435e-4,1579,6052349,1,Optional,2002,1542,5934660,2.598295437312331e-4,0,1,1,2.608904410502435e-4,53
WA,2003,3.8965991808851086e-4,47,120618,2.8390683989407145e-4,1733,6104115,1,Optional,2003,1686,5983497,2.817750221985571e-4,0,1,1,2.8390683989407145e-4,53
WA,2004,0.001091992,136,124543,0.001340261,8281,6178645,1,Optional,2004,8145,6054102,0.001345369,0,1,1,0.001340261,53
WA,2005,0.00100032,128,127959,0.001448547,9064,6257305,1,Optional,2005,8936,6129346,0.001457904,0,1,1,0.001448547,53
WA,2006,9.109749709626728e-4,120,131727,0.001405171,8952,6370753,1,Optional,2006,8832,6239026,0.001415606,0,1,1,0.001405171,53
WA,2007,0.001065417,145,136097,0.001446084,9344,6461587,1,Optional,2007,9199,6325490,0.001454275,0,1,1,0.001446084,53
WA,2008,0.001277393,180,140912,0.001474041,9673,6562231,1,Optional,2008,9493,6421319,0.001478357,0,1,1,0.001474041,53
WA,2009,0.001105469,160,144735,0.001421238,9476,6667426,1,Optional,2009,9316,6522691,0.001428245,0,1,1,0.001421238,53
WA,2010,0.0012718,188,147822,0.001426269,9591,6724540,1,Optional,2010,9403,6576718,0.00142974,0,1,1,0.001426269,53
WA,2011,0.001283808,193,150334,0.00145885,9964,6830038,1,Optional,2011,9771,6679704,0.001462789,0,1,1,0.00145885,53
WA,2012,0.001417993,216,152328,0.001460198,10071,6897012,1,Optional,2012,9855,6744684,0.001461151,0,1,1,0.001460198,53
WA,2013,0.001220593,190,155662,0.001501849,10470,6971406,1,Optional,2013,10280,6815744,0.001508273,0,1,1,0.001501849,53
WA,2014,0.001492313,238,159484,0.001509021,10656,7061530,1,Optional,2014,10418,6902046,0.001509408,0,1,1,0.001509021,53
WA,2015,0.001410861,230,163021,0.001613031,11566,7170351,1,Optional,2015,11336,7007330,0.001617735,0,1,1,0.001613031,53
WA,2016,0.001498637,249,166151,0.001510154,11006,7288000,1,Optional,2016,10757,7121849,0.001510422,0,1,1,0.001510154,53
WA,2017,0.001625901,276,169752,0.001574859,11663,7405743,1,Optional,2017,11387,7235991,0.001573661,0,1,1,0.001574859,53
WA,2018,0.001628298,282,173187,0.001550509,11684,7535591,1,Optional,2018,11402,7362404,0.001548679,0,1,1,0.001550509,53
WA,2019,0.001596419,281,176019,0.001576253,12003,7614893,1,Optional,2019,11722,7438874,0.001575776,0,1,1,0.001576253,53
WA,2020,0.001850853,333,179917,0.001629404,12536,7693612,1,Optional,2020,12203,7513695,0.001624101,0,1,1,0.001629404,53
WI,1999,9.893936995409214e-5,5,50536,1.1607702413764522e-4,619,5332666,1,Mandatory,1999,614,5282130,1.1624098611734281e-4,1,0,2,1.1607702413764522e-4,55
WI,2000,9.417082587814295e-5,5,53095,1.4076169790302358e-4,755,5363675,1,Mandatory,2000,750,5310580,1.4122751187252617e-4,1,0,2,1.4076169790302358e-4,55
WI,2001,9.239070179977087e-5,5,54118,1.5517396036683197e-4,839,5406835,1,Mandatory,2001,834,5352717,1.558087229345396e-4,1,0,2,1.5517396036683197e-4,55
WI,2002,2.3411612159631177e-4,13,55528,1.63631495261298e-4,891,5445162,1,Mandatory,2002,878,5389634,1.629053104533629e-4,1,0,2,1.63631495261298e-4,55
WI,2003,0.001246992,71,56937,0.001331398,7295,5479203,1,Mandatory,2003,7224,5422266,0.001332284,1,0,2,0.001331398,55
WI,2004,0.001337953,78,58298,0.001394444,7689,5514026,1,Mandatory,2004,7611,5455728,0.001395048,1,0,2,0.001394444,55
WI,2005,0.001569413,94,59895,0.001457944,8086,5546166,1,Mandatory,2005,7992,5486271,0.001456727,1,0,2,0.001457944,55
WI,2006,0.001272784,78,61283,0.001452044,8099,5577655,1,Mandatory,2006,8021,5516372,0.001454035,1,0,2,0.001452044,55
WI,2007,0.001631993,103,63113,0.001476267,8283,5610775,1,Mandatory,2007,8180,5547662,0.001474495,1,0,2,0.001476267,55
WI,2008,0.001421596,92,64716,0.001450099,8180,5640996,1,Mandatory,2008,8088,5576280,0.001450429,1,0,2,0.001450099,55
WI,2009,0.001556691,103,66166,0.001436871,8146,5669264,1,Mandatory,2009,8043,5603098,0.001435456,1,0,2,0.001436871,55
WI,2010,0.001712834,116,67724,0.001513455,8607,5686986,1,Mandatory,2010,8491,5619262,0.001511053,1,0,2,0.001513455,55
WI,2011,0.001629209,112,68745,0.001548908,8847,5711767,1,Mandatory,2011,8735,5643022,0.001547929,1,0,2,0.001548908,55
WI,2012,0.001762051,123,69805,0.001546522,8856,5726398,1,Mandatory,2012,8733,5656593,0.001543862,1,0,2,0.001546522,55
WI,2013,0.001689665,120,71020,0.001641384,9426,5742713,1,Mandatory,2013,9306,5671693,0.00164078,1,0,2,0.001641384,55
WI,2014,0.001649227,119,72155,0.001626903,9367,5757564,1,Mandatory,2014,9248,5685409,0.00162662,1,0,2,0.001626903,55
WI,2015,0.001601007,117,73079,0.001612451,9306,5771337,1,Mandatory,2015,9189,5698258,0.001612598,1,0,2,0.001612451,55
WI,2016,0.001530647,113,73825,0.001672519,9665,5778708,1,Mandatory,2016,9552,5704883,0.001674355,1,0,2,0.001672519,55
WI,2017,0.001959451,147,75021,0.001676478,9716,5795483,1,Mandatory,2017,9569,5720462,0.001672767,1,0,2,0.001676478,55
WI,2018,0.002000342,152,75987,0.001685884,9801,5813568,1,Mandatory,2018,9649,5737581,0.001681719,1,0,2,0.001685884,55
WI,2019,0.001865647,144,77185,0.001713888,9979,5822434,1,Mandatory,2019,9835,5745249,0.001711849,1,0,2,0.001713888,55
WI,2020,0.002548304,201,78876,0.001835185,10704,5832655,1,Mandatory,2020,10503,5753779,0.001825409,1,0,2,0.001835185,55
WY,1999,0,0,11689,1.4437350034568304e-4,71,491780,0,No,1999,71,480091,1.4788862944733395e-4,0,0,0,0,56
WY,2000,4.078303425774878e-4,5,12260,2.490977799919803e-4,123,493782,0,No,2000,118,481522,2.4505630064669944e-4,0,0,0,0,56
WY,2001,3.9538193895302865e-4,5,12646,2.142899018916138e-4,106,494657,0,No,2001,101,482011,2.0953878645923018e-4,0,0,0,0,56
WY,2002,3.874467260751647e-4,5,12905,2.2199245225662328e-4,111,500017,0,No,2002,106,487112,2.1760909195421175e-4,0,0,0,0,56
WY,2003,3.842311534619227e-4,5,13013,3.217778024959629e-4,162,503453,0,No,2003,157,490440,3.2012070793573116e-4,0,0,0,0,56
WY,2004,3.750093752343809e-4,5,13333,0.001596917,813,509106,0,No,2004,808,495773,0.001629778,0,0,0,0,56
WY,2005,3.6743092298647856e-4,5,13608,0.001606513,826,514157,0,No,2005,821,500549,0.001640199,0,0,0,0,56
WY,2006,0.001838755,26,14140,0.001681759,879,522667,0,No,2006,853,508527,0.001677394,0,0,0,0,56
WY,2007,0.001495683,22,14709,0.00165272,884,534876,0,No,2007,862,520167,0.00165716,0,0,0,0,56
WY,2008,9.183338799606428e-4,14,15245,0.001626246,888,546043,0,No,2008,874,530798,0.001646577,0,0,0,0,56
WY,2009,7.658433850277618e-4,12,15669,0.001609357,901,559851,0,No,2009,889,544182,0.001633645,0,0,0,0,56
WY,2010,0.001072758,17,15847,0.001763581,994,563626,0,No,2010,977,547779,0.001783566,0,0,0,0,56
WY,2011,6.178942165101335e-4,10,16184,0.001643909,934,568158,0,No,2011,924,551974,0.001673992,0,0,0,0,56
WY,2012,0.002066869,34,16450,0.001724461,994,576412,0,No,2012,960,559962,0.001714402,0,0,0,0,56
WY,2013,0.001017355,17,16710,0.001642473,957,582658,0,No,2013,940,565948,0.00166093,0,0,0,0,56
WY,2014,9.964245941035108e-4,17,17061,0.001722152,1006,584153,0,No,2014,989,567092,0.001743985,0,0,0,0,56
WY,2015,0.001152937,20,17347,0.001798306,1054,586107,0,No,2015,1034,568760,0.00181799,0,0,0,0,56
WY,2016,0.001388326,24,17287,0.001784796,1045,585501,0,No,2016,1021,568214,0.001796858,0,0,0,0,56
WY,2017,0.001096555,19,17327,0.001788319,1036,579315,0,No,2017,1017,561988,0.001809647,0,0,0,0,56
WY,2018,0.001373548,24,17473,0.001924751,1112,577737,0,No,2018,1088,560264,0.001941942,0,0,0,0,56
WY,2019,0.00160901,28,17402,0.001857423,1075,578759,0,No,2019,1047,561357,0.001865123,0,0,0,0,56
WY,2020,0.002272979,41,18038,0.002191205,1276,582328,0,No,2020,1235,564290,0.002188591,0,0,0,0,56